CCCCCATAATAACTTGAAT -> CCCCATAATAACTTGAATA
CTGTTTAACTGTGACCGGT -> TGTTTAACTGTGACCGGTT
GTCTAATGCGGTTAACGAA -> TCTAATGCGGTTAACGAAG
CCATTCTACAGTAATGTCG -> CATTCTACAGTAATGTCGA
GAAGGCTTTTAGGCTGGGG -> AAGGCTTTTAGGCTGGGGG
CTGAAGGTACTGACTTGAC -> TGAAGGTACTGACTTGACA
GCACATGTACGACCTATAG -> CACATGTACGACCTATAGC
GGGCAACACTTTGCGACGA -> GGCAACACTTTGCGACGAC
TCCAAAGTATATGACAACT -> CCAAAGTATATGACAACTA
CTCGGGTCGAAATGCATGA -> TCGGGTCGAAATGCATGAG
AAGATAGAGTTATTGTCTC -> AGATAGAGTTATTGTCTCC
TCGCTTCTGGCACCCGACT -> CGCTTCTGGCACCCGACTC
TCCTATACCATTCTACAGT -> CCTATACCATTCTACAGTA
TCTTGTAGTGTTACATATT -> CTTGTAGTGTTACATATTC
CTGCTTTTTCATGACTGCG -> TGCTTTTTCATGACTGCGC
CCGAAAAAAAGGGCAACAC -> CGAAAAAAAGGGCAACACT
ACAAGTCGCAGAGCCACCC -> CAAGTCGCAGAGCCACCCG
CCAATCAAGGAAGCATTGT -> CAATCAAGGAAGCATTGTG
TCTATACACTTAAATCACT -> CTATACACTTAAATCACTA
TACAAAAGATAGAGTTATT -> ACAAAAGATAGAGTTATTG
GACTAGTTCGGGTCAAGTG -> ACTAGTTCGGGTCAAGTGA
CCCACGCCTCGTAGTGGCA -> CCACGCCTCGTAGTGGCAC
TCAAACCCCCCCGCGCGGA -> CAAACCCCCCCGCGCGGAA
ATGCCTGTGACACTCTTGC -> TGCCTGTGACACTCTTGCT
CCCGAAGCTTGAGAACGGT -> CCGAAGCTTGAGAACGGTT
GGTTACGAGGCAACAGGGT -> GTTACGAGGCAACAGGGTA
CCTGAAGGTACTGACTTGA -> CTGAAGGTACTGACTTGAC
ACGATTGAGTCTTTACTGC -> CGATTGAGTCTTTACTGCT
GAATACAGTTGGTTATGGG -> AATACAGTTGGTTATGGGC
GCGACGGACCGAACTCCAC -> CGACGGACCGAACTCCACA
GGCCAACAGGACCTGATCC -> GCCAACAGGACCTGATCCC
GTCCTTAACTGCCGCGTAA -> TCCTTAACTGCCGCGTAAC
TATTGCCGGCACCTTAAAC -> ATTGCCGGCACCTTAAACT
GAACAGGGTGCCGCAAGAA -> AACAGGGTGCCGCAAGAAG
CATACTTCCTTTAATTAGA -> ATACTTCCTTTAATTAGAA
GTCATGTCAGTACCCCAAC -> TCATGTCAGTACCCCAACT
TTCCCCGAAGCTTGAGAAC -> TCCCCGAAGCTTGAGAACG
TCTCGGAAGTTCATCCGAG -> CTCGGAAGTTCATCCGAGT
GTTATTGTCTCCCCCATAA -> TTATTGTCTCCCCCATAAG
ACGTCCGCGCCATACGGTT -> CGTCCGCGCCATACGGTTC
GTAATGTCGATAAAACTGT -> TAATGTCGATAAAACTGTC
GGCAGCCTTCGTGCTGGAT -> GCAGCCTTCGTGCTGGATA
TACTATGAACTAGAACTCC -> ACTATGAACTAGAACTCCG
CCCCCGAGAAGTTTCGGCT -> CCCCGAGAAGTTTCGGCTC
CACTACAGGGAACAGGGTG -> ACTACAGGGAACAGGGTGC
CGCGGGGCATGTTCTAGTG -> GCGGGGCATGTTCTAGTGA
CGCAAGGGTTTCGGTTACT -> GCAAGGGTTTCGGTTACTG
ACTGCTCTCGGAAGTTCAT -> CTGCTCTCGGAAGTTCATC
GCTGCGCGATAGTCACTGT -> CTGCGCGATAGTCACTGTG
CGCTACGGAACGCGGGGCA -> GCTACGGAACGCGGGGCAT
GATGCGTCTAGCTTGCTTG -> ATGCGTCTAGCTTGCTTGT
GACGAGTGTTCCAATCAAG -> ACGAGTGTTCCAATCAAGG
CGATTCAGACTCTTGTAGT -> GATTCAGACTCTTGTAGTG
ATCGGGACGAGTGTTCCAA -> TCGGGACGAGTGTTCCAAT
CGCGAGGTCATGTCAGTAC -> GCGAGGTCATGTCAGTACC
GCCCGGATGTCTAATCGCC -> CCCGGATGTCTAATCGCCC
GTTTAGGCTGGCAGCCTTC -> TTTAGGCTGGCAGCCTTCG
TGCTAGCTGGGGAGCCTGT -> GCTAGCTGGGGAGCCTGTT
GGGTCAAGTGACTTAGTAA -> GGTCAAGTGACTTAGTAAG
GCGATTCAGACTCTTGTAG -> CGATTCAGACTCTTGTAGT
TTTACTGCTCTCGGAAGTT -> TTACTGCTCTCGGAAGTTC
GTTCTAGTGAAGTAAACCC -> TTCTAGTGAAGTAAACCCC
TCACTACATTCCAAGCGGA -> CACTACATTCCAAGCGGAC
GTGCTACATGAAATCTCTC -> TGCTACATGAAATCTCTCG
ACACTTAAATCACTACATT -> CACTTAAATCACTACATTC
GACCTATAGCTGGCCGACC -> ACCTATAGCTGGCCGACCC
TACGATGGTGCAAGGTGCT -> ACGATGGTGCAAGGTGCTT
GCAACGCTAGTAGTGCCCA -> CAACGCTAGTAGTGCCCAT
TAGTAGTGCCCATTGCACA -> AGTAGTGCCCATTGCACAC
GGTACTATGAACTAGAACT -> GTACTATGAACTAGAACTC
CTTGACAAACCTCCAGCCA -> TTGACAAACCTCCAGCCAA
TCGTGCTGGATAGAAACTG -> CGTGCTGGATAGAAACTGA
GTTAACGCCGCGGTATACA -> TTAACGCCGCGGTATACAA
ACTTGACAAGTGGTAAGTT -> CTTGACAAGTGGTAAGTTC
GTGCCCATTGCACACGCCA -> TGCCCATTGCACACGCCAC
GATCCCATGCCTGTGACAC -> ATCCCATGCCTGTGACACT
ACGTACGATGGTGCAAGGT -> CGTACGATGGTGCAAGGTG
TCTACAGTAATGTCGATAA -> CTACAGTAATGTCGATAAA
AGTTATTGTCTCCCCCATA -> GTTATTGTCTCCCCCATAA
AGGACCTGATCCCATGCCT -> GGACCTGATCCCATGCCTG
CGATTAGTATATGACTCAC -> GATTAGTATATGACTCACC
GAACCAGGAAAACTTGACA -> AACCAGGAAAACTTGACAA
TCGTAGTGGCACTACAGGG -> CGTAGTGGCACTACAGGGA
CTATAGACGTAAGTCGTGT -> TATAGACGTAAGTCGTGTA
ACTCTTGCTAGGCAGGTCA -> CTCTTGCTAGGCAGGTCAA
ACACGTCCTTTCTATACAC -> CACGTCCTTTCTATACACT
AAAAGGGCAACACTTTGCG -> AAAGGGCAACACTTTGCGA
CGCGGAACGGAGATGTGAG -> GCGGAACGGAGATGTGAGC
GCGGTTAACGAAGGGATTA -> CGGTTAACGAAGGGATTAC
GACGACCACGATTGAGTCT -> ACGACCACGATTGAGTCTT
TTCGGCTCCTATACCATTC -> TCGGCTCCTATACCATTCT
ATGCCCTTGACAAACCTCC -> TGCCCTTGACAAACCTCCA
CCGACTCCTGATCTGACAA -> CGACTCCTGATCTGACAAG
GTAAATCCAAGGTCTCGGC -> TAAATCCAAGGTCTCGGCC
GTGCTAGCTGGGGAGCCTG -> TGCTAGCTGGGGAGCCTGT
ACAACGTTCTATCTGGGAA -> CAACGTTCTATCTGGGAAG
GTTTTGGAAAACTGCGACG -> TTTTGGAAAACTGCGACGG
GCACCTTAAACTCCCAATA -> CACCTTAAACTCCCAATAA
TCCATGTGATTTAAAGGGC -> CCATGTGATTTAAAGGGCC
GGACCGAACTCCACATATT -> GACCGAACTCCACATATTT
GCAATTATTGTCTCCCCCA -> CAATTATTGTCTCCCCCAT
CCCGAGAAGTTTCGGCTCC -> CCGAGAAGTTTCGGCTCCT
CCCTTGACAAACCTCCAGC -> CCTTGACAAACCTCCAGCC
CGACGACCACGATTGAGTC -> GACGACCACGATTGAGTCT
CCACCATCGCTATCGGGAC -> CACCATCGCTATCGGGACG
AAGGGCAACACTTTGCGAC -> AGGGCAACACTTTGCGACG
GGCGCGAGGTCATGTCAGT -> GCGCGAGGTCATGTCAGTA
TATTGTTTACTCGGGTCGA -> ATTGTTTACTCGGGTCGAA
TCGAAATGCATGAGGAAGG -> CGAAATGCATGAGGAAGGC
CCCCCCCGCGCGGAACGGA -> CCCCCCGCGCGGAACGGAG
ACGGTTCCATGTGATTTAA -> CGGTTCCATGTGATTTAAA
ACGTCCTTTCTATACACTT -> CGTCCTTTCTATACACTTA
GCGATAGTCACTGTGTCCT -> CGATAGTCACTGTGTCCTT
TGGCCGACCCACCATCGCT -> GGCCGACCCACCATCGCTA
CAGTCCGCGAACGCCCTTC -> AGTCCGCGAACGCCCTTCC
AATAGTATATCTATCTGAG -> ATAGTATATCTATCTGAGT
AGCTTGCTTGTTTCTCCGG -> GCTTGCTTGTTTCTCCGGT
GCACTAACCACACGCGACA -> CACTAACCACACGCGACAG
GCCGGACAACGTTCTATCT -> CCGGACAACGTTCTATCTG
TAGGCAGGTCAAACCCCCC -> AGGCAGGTCAAACCCCCCC
TGCACACGCCACGCCCGCA -> GCACACGCCACGCCCGCAT
AAAACTGTCGTAAAATCTC -> AAACTGTCGTAAAATCTCT
ACGGAGATGTGAGCTGTGT -> CGGAGATGTGAGCTGTGTA
CATCTTAAGACTTTTCCTG -> ATCTTAAGACTTTTCCTGC
CTACCGAAAAAAAGGGCAA -> TACCGAAAAAAAGGGCAAC
GTTCGAGGTGACGCCCTCG -> TTCGAGGTGACGCCCTCGG
ATAGAAACTGAGCCCCCGC -> TAGAAACTGAGCCCCCGCA
GAATCCGGATCGCTTCTGG -> AATCCGGATCGCTTCTGGC
AGTAAATCCAAGGTCTCGG -> GTAAATCCAAGGTCTCGGC
GGTCAAGTGACTTAGTAAG -> GTCAAGTGACTTAGTAAGT
TGACAAGTGGTAAGTTCAA -> GACAAGTGGTAAGTTCAAA
CCTGCCAGGACATACTTCC -> CTGCCAGGACATACTTCCT
TGTGACTTTATTGTCTCCC -> GTGACTTTATTGTCTCCCC
GCAGAGCCACCCGAGTTCT -> CAGAGCCACCCGAGTTCTT
CAACAGGGTACTATGAACT -> AACAGGGTACTATGAACTA
GCTGTGTAGGCAGCACTAA -> CTGTGTAGGCAGCACTAAC
CGACGGTCTAATGCGGTTA -> GACGGTCTAATGCGGTTAA
TATACAAAAGATAGAGTTA -> ATACAAAAGATAGAGTTAT
ACTATGAACTAGAACTCCG -> CTATGAACTAGAACTCCGT
CCGGATGTCTAATCGTCGG -> CGGATGTCTAATCGTCGGT
GGTAAGTTCAAAGTAAATC -> GTAAGTTCAAAGTAAATCC
ACTGCTATAGACGTAAGTC -> CTGCTATAGACGTAAGTCG
CACAGTCCGCGAACGCCCT -> ACAGTCCGCGAACGCCCTT
TACAACGTGCAGTTCGAAT -> ACAACGTGCAGTTCGAATA
AAGGGATTACACGTCCTTT -> AGGGATTACACGTCCTTTC
CTGGCAGCCTTCGTGCTGG -> TGGCAGCCTTCGTGCTGGA
TATCTGGGAAGCTGCCGCA -> ATCTGGGAAGCTGCCGCAA
GCCCTCTATTGTTTACTCG -> CCCTCTATTGTTTACTCGG
CCATACGGTTCCGATTAGT -> CATACGGTTCCGATTAGTA
TAAGTCTTCCCGTCCCACG -> AAGTCTTCCCGTCCCACGC
CTGCTATAGACGTAAGTCG -> TGCTATAGACGTAAGTCGT
GCCCATTGCACACGCCACG -> CCCATTGCACACGCCACGC
AACGCCGCGGTATACAAAA -> ACGCCGCGGTATACAAAAG
ATGTCGATAAAACTGTCGT -> TGTCGATAAAACTGTCGTA
CCCATGCCTGTGACACTCT -> CCATGCCTGTGACACTCTT
GCCAACTGAGTGTGCGCTT -> CCAACTGAGTGTGCGCTTA
CCGATTAGTATATGACTCA -> CGATTAGTATATGACTCAC
AAGTCGTGTAGAGGGCGCC -> AGTCGTGTAGAGGGCGCCC
AAACTCCCAATAAGTCTTC -> AACTCCCAATAAGTCTTCC
GTGTAGAGGGCGCCCCCAT -> TGTAGAGGGCGCCCCCATC
ATGTCTAATCGCCCGAGAT -> TGTCTAATCGCCCGAGATT
CGACCTATAGCTGGCCGAC -> GACCTATAGCTGGCCGACC
CTGTGTAGGCAGCACTAAC -> TGTGTAGGCAGCACTAACC
TACAGTTGGTTATGGGCAT -> ACAGTTGGTTATGGGCATC
AACTGTCGTAAAATCTCTA -> ACTGTCGTAAAATCTCTAC
CAACTAAACACAGAGCAAG -> AACTAAACACAGAGCAAGA
GCTATCGGGACGAGTGTTC -> CTATCGGGACGAGTGTTCC
GCCAAACCACACGCCAATA -> CCAAACCACACGCCAATAC
CACTCCTAGGATTTGCTCA -> ACTCCTAGGATTTGCTCAC
GACTGGTTACGAGGCAACA -> ACTGGTTACGAGGCAACAG
CCCTCTATTGTTTACTCGG -> CCTCTATTGTTTACTCGGG
AGCGGACTAGTTCGGGTCA -> GCGGACTAGTTCGGGTCAA
TTGCTCACAACAAACGGAG -> TGCTCACAACAAACGGAGG
TCAGCTAATCTCCTTCTAT -> CAGCTAATCTCCTTCTATC
CGAAGCTTGAGAACGGTTC -> GAAGCTTGAGAACGGTTCC
TCAAGTGACTTAGTAAGTG -> CAAGTGACTTAGTAAGTGC
ACATTCTAAGAAGGTTAAC -> CATTCTAAGAAGGTTAACG
TCTGGCACCCGACTCCTGA -> CTGGCACCCGACTCCTGAT
GTCGGTGTAGTAAGCCTTC -> TCGGTGTAGTAAGCCTTCT
TGACTCACCTCGAGACCTA -> GACTCACCTCGAGACCTAT
TGTGCGCTTAAACCGACTG -> GTGCGCTTAAACCGACTGG
CCCCATCTTAAGACTTTTC -> CCCATCTTAAGACTTTTCC
GAAGTGAGCCAATAGTACA -> AAGTGAGCCAATAGTACAT
GCCAATAGTACATTCTAAG -> CCAATAGTACATTCTAAGA
TTCAGCAATGCGGTGGGTC -> TCAGCAATGCGGTGGGTCC
TAGTAAGCCTTCTCGCACT -> AGTAAGCCTTCTCGCACTC
GGTCAAACCCCCCCGCGCG -> GTCAAACCCCCCCGCGCGG
GTTCATCCGAGTACGTAAC -> TTCATCCGAGTACGTAACC
CCAACTGAGTGTGCGCTTA -> CAACTGAGTGTGCGCTTAA
GGAAAACTGCGACGGACCG -> GAAAACTGCGACGGACCGA
GGCAGCCCGGATGTCTAAT -> GCAGCCCGGATGTCTAATC
CCTCTAAACCGACTACTGC -> CTCTAAACCGACTACTGCT
CGCCTCGTAGTGGCACTAC -> GCCTCGTAGTGGCACTACA
CCCGTCCCACGCCTCGTAG -> CCGTCCCACGCCTCGTAGT
TAAATTTTGTTAGGCAGCC -> AAATTTTGTTAGGCAGCCC
TGAGCTGTGTAGGCAGCAC -> GAGCTGTGTAGGCAGCACT
ATAGTCACTGTGTCCTTAA -> TAGTCACTGTGTCCTTAAC
CAGATTGTCAACAGTGGAA -> AGATTGTCAACAGTGGAAT
TCCCCCATAAATTTTGTTA -> CCCCCATAAATTTTGTTAG
CTCCGTTTCCCCGAAGCTT -> TCCGTTTCCCCGAAGCTTG
CAGTCCACCATCCAAAGTA -> AGTCCACCATCCAAAGTAT
TAAAGGGCCAACAGGACCT -> AAAGGGCCAACAGGACCTG
ACGAGGCAACAGGGTACTA -> CGAGGCAACAGGGTACTAT
TTGACAGCTCTCTTGGTTT -> TGACAGCTCTCTTGGTTTT
CCTCGTAGTGGCACTACAG -> CTCGTAGTGGCACTACAGG
ATCTGGGAAGCTGCCGCAA -> TCTGGGAAGCTGCCGCAAT
CTTTATTGTCTCCCCCATA -> TTTATTGTCTCCCCCATAA
CTCCACATATTTGGACATG -> TCCACATATTTGGACATGC
ACTGACTTGACAGCTCTCT -> CTGACTTGACAGCTCTCTT
CATCCAAAGTATATGACAA -> ATCCAAAGTATATGACAAC
TGTACGACCTATAGCTGGC -> GTACGACCTATAGCTGGCC
GTTGTGACTTTATTGTCTC -> TTGTGACTTTATTGTCTCC
TCAAATCACTCCTAGGATT -> CAAATCACTCCTAGGATTT
ACTCGGGTCGAAATGCATG -> CTCGGGTCGAAATGCATGA
GGCCTCTAAACCGACTACT -> GCCTCTAAACCGACTACTG
GGCAACACTTTGCGACGAC -> GCAACACTTTGCGACGACC
TAACTTGAATACAGCCCGG -> AACTTGAATACAGCCCGGA
AGAACCAGGAAAACTTGAC -> GAACCAGGAAAACTTGACA
CTTTTTCATGACTGCGCTA -> TTTTTCATGACTGCGCTAC
TTTCCTGCCAGGACATACT -> TTCCTGCCAGGACATACTT
ACAGTGGAATGCCCTTGAC -> CAGTGGAATGCCCTTGACA
ATTGTCAACAGTGGAATGC -> TTGTCAACAGTGGAATGCC
GGTGCTAGCTGGGGAGCCT -> GTGCTAGCTGGGGAGCCTG
TGTGAGCTGTGTAGGCAGC -> GTGAGCTGTGTAGGCAGCA
ATCGCTATCGGGACGAGTG -> TCGCTATCGGGACGAGTGT
CCAACTGAATAGTATATCT -> CAACTGAATAGTATATCTA
CCTTAAACTCCCAATAAGT -> CTTAAACTCCCAATAAGTC
GGGGCGATTCAGACTCTTG -> GGGCGATTCAGACTCTTGT
GTGTCATCGTCTACCGAAA -> TGTCATCGTCTACCGAAAA
ACACTTTGCGACGACCACG -> CACTTTGCGACGACCACGA
CAGGGTGCCGCAAGAAGTC -> AGGGTGCCGCAAGAAGTCA
CCCCTTGCTCTTATTGTCT -> CCCTTGCTCTTATTGTCTC
CAATGGGTTTAGGTGACCC -> AATGGGTTTAGGTGACCCG
TAGTGTTACATATTCTCAT -> AGTGTTACATATTCTCATT
ACTTTTCCTGCCAGGACAT -> CTTTTCCTGCCAGGACATA
ATTGTTTACTCGGGTCGAA -> TTGTTTACTCGGGTCGAAA
GGCGATTCAGACTCTTGTA -> GCGATTCAGACTCTTGTAG
TACGTACGATGGTGCAAGG -> ACGTACGATGGTGCAAGGT
GATACCGACGGTCTAATGC -> ATACCGACGGTCTAATGCG
GGAAGGCTTTTAGGCTGGG -> GAAGGCTTTTAGGCTGGGG
ATAGAAGTGAGCCAATAGT -> TAGAAGTGAGCCAATAGTA
GTCACACAGTCCGCGAACG -> TCACACAGTCCGCGAACGC
TGTGTAGGCAGCACTAACC -> GTGTAGGCAGCACTAACCA
TTGAGAACGGTTCCATGTG -> TGAGAACGGTTCCATGTGA
GCCCCCCTTGCTCTTATTG -> CCCCCCTTGCTCTTATTGT
CCATCTTAAGACTTTTCCT -> CATCTTAAGACTTTTCCTG
GGCAGGTCAAACCCCCCCG -> GCAGGTCAAACCCCCCCGC
CCAAGCGGACTAGTTCGGG -> CAAGCGGACTAGTTCGGGT
ACAGGGTACTATGAACTAG -> CAGGGTACTATGAACTAGA
AGGGTACTATGAACTAGAA -> GGGTACTATGAACTAGAAC
AAATCACTCCTAGGATTTG -> AATCACTCCTAGGATTTGC
ACATATTCTCATTTTCTCA -> CATATTCTCATTTTCTCAA
TCGCAGAGCCACCCGAGTT -> CGCAGAGCCACCCGAGTTC
CTGGATAGAAACTGAGCCC -> TGGATAGAAACTGAGCCCC
TCTCCTTCTATCTACCTGT -> CTCCTTCTATCTACCTGTG
TTACAGCCCGGATGTCTAA -> TACAGCCCGGATGTCTAAT
TGGCACCCGACTCCTGATC -> GGCACCCGACTCCTGATCT
AAACCCCCCCGCGCGGAAC -> AACCCCCCCGCGCGGAACG
GCCTCGTAGTGGCACTACA -> CCTCGTAGTGGCACTACAG
AGGTCATGTCAGTACCCCA -> GGTCATGTCAGTACCCCAA
GTGACTTTATTGTCTCCCC -> TGACTTTATTGTCTCCCCC
TTATGGGCATCCAGATTGT -> TATGGGCATCCAGATTGTC
CAACTGAATAGTATATCTA -> AACTGAATAGTATATCTAT
CGAAATGCATGAGGAAGGC -> GAAATGCATGAGGAAGGCT
GCAGCCTTCGTGCTGGATA -> CAGCCTTCGTGCTGGATAG
CAGGACCTGATCCCATGCC -> AGGACCTGATCCCATGCCT
ATGTGATTTAAAGGGCCAA -> TGTGATTTAAAGGGCCAAC
GGGTTTAGGTGACCCGTTG -> GGTTTAGGTGACCCGTTGT
GTCTAATCGTCGGTGTAGT -> TCTAATCGTCGGTGTAGTA
TTCGGTTACTGCTATAGAC -> TCGGTTACTGCTATAGACG
CCATAAATTTTGTTAGGCA -> CATAAATTTTGTTAGGCAG
CTAGTGAAGTAAACCCCCG -> TAGTGAAGTAAACCCCCGA
ATTGTGTCATCGTCTACCG -> TTGTGTCATCGTCTACCGA
GCCCGCATGTCTATTGCCG -> CCCGCATGTCTATTGCCGG
TAAGACTTTTCCTGCCAGG -> AAGACTTTTCCTGCCAGGA
TTGCCGGCACCTTAAACTC -> TGCCGGCACCTTAAACTCC
CTTCCCGTCCCACGCCTCG -> TTCCCGTCCCACGCCTCGT
TAAATCCAAGGTCTCGGCC -> AAATCCAAGGTCTCGGCCT
AGTGCCCATTGCACACGCC -> GTGCCCATTGCACACGCCA
CGGTTCCGATTAGTATATG -> GGTTCCGATTAGTATATGA
CCCCCATCTTAAGACTTTT -> CCCCATCTTAAGACTTTTC
AAAAGATAGAGTTATTGTC -> AAAGATAGAGTTATTGTCT
GCCACGCCCGCATGTCTAT -> CCACGCCCGCATGTCTATT
TGCTCTCGGAAGTTCATCC -> GCTCTCGGAAGTTCATCCG
TGGGGGCGATTCAGACTCT -> GGGGGCGATTCAGACTCTT
GCCCGAGATTCAGCAATGC -> CCCGAGATTCAGCAATGCG
GTACGAATACAGTTGGTTA -> TACGAATACAGTTGGTTAT
CACACAGTCCGCGAACGCC -> ACACAGTCCGCGAACGCCC
ACCGAAAAAAAGGGCAACA -> CCGAAAAAAAGGGCAACAC
CTGGCCGACCCACCATCGC -> TGGCCGACCCACCATCGCT
CTGAATAGTATATCTATCT -> TGAATAGTATATCTATCTG
TTAGGCAGCCCGGATGTCT -> TAGGCAGCCCGGATGTCTA
ACCCGAGTTCTTAATGCCG -> CCCGAGTTCTTAATGCCGC
TTGTCTCCCCCATAACTTG -> TGTCTCCCCCATAACTTGA
GTAAGTTCAAAGTAAATCC -> TAAGTTCAAAGTAAATCCA
AAGAAGTCACACAGTCCGC -> AGAAGTCACACAGTCCGCG
AACAGGGTACTATGAACTA -> ACAGGGTACTATGAACTAG
ACTTGATAATTACAGCCCG -> CTTGATAATTACAGCCCGG
TGTTCCAATCAAGGAAGCA -> GTTCCAATCAAGGAAGCAT
CGGGTCGAAATGCATGAGG -> GGGTCGAAATGCATGAGGA
GGAGATGGGGTAACGTCCG -> GAGATGGGGTAACGTCCGC
TTTGCGACGACCACGATTG -> TTGCGACGACCACGATTGA
AGGCAGCACTAACCACACG -> GGCAGCACTAACCACACGC
CGGATGTCTAATCGTCCTA -> GGATGTCTAATCGTCCTAT
AATAGTACATTCTAAGAAG -> ATAGTACATTCTAAGAAGG
CGTCTAGCTTGCTTGTTTC -> GTCTAGCTTGCTTGTTTCT
ACAGTTGGTTATGGGCATC -> CAGTTGGTTATGGGCATCC
CTTCCTTTAATTAGAACCA -> TTCCTTTAATTAGAACCAG
ATCAAGGAAGCATTGTGTC -> TCAAGGAAGCATTGTGTCA
TCGTAAAATCTCTACAATG -> CGTAAAATCTCTACAATGG
TACATGAAATCTCTCGCGC -> ACATGAAATCTCTCGCGCC
AATGTCGATAAAACTGTCG -> ATGTCGATAAAACTGTCGT
CCGCATGTCTATTGCCGGC -> CGCATGTCTATTGCCGGCA
TCGGTGCTAGCTGGGGAGC -> CGGTGCTAGCTGGGGAGCC
CCATGTGATTTAAAGGGCC -> CATGTGATTTAAAGGGCCA
GGGGAGCCTGTTTAACTGT -> GGGAGCCTGTTTAACTGTG
TGCTTAGTGATGCGTCTAG -> GCTTAGTGATGCGTCTAGC
CCGGGCACATGTACGACCT -> CGGGCACATGTACGACCTA
TCCTTTCTATACACTTAAA -> CCTTTCTATACACTTAAAT
TTAAACCGACTGGTTACGA -> TAAACCGACTGGTTACGAG
CGTTGTGACTTTATTGTCT -> GTTGTGACTTTATTGTCTC
GACAAACCTCCAGCCAACT -> ACAAACCTCCAGCCAACTG
CGACTCCTGATCTGACAAG -> GACTCCTGATCTGACAAGG
CTGCCGCAATTATTGTCTC -> TGCCGCAATTATTGTCTCC
CGACTACTGCTTTTTCATG -> GACTACTGCTTTTTCATGA
TGATTTCGCCAAACCACAC -> GATTTCGCCAAACCACACG
AAAATCTCTACAATGGGTT -> AAATCTCTACAATGGGTTT
GTAAGTCGTGTAGAGGGCG -> TAAGTCGTGTAGAGGGCGC
CCTGTTTAACTGTGACCGG -> CTGTTTAACTGTGACCGGT
AGGCAGGTCAAACCCCCCC -> GGCAGGTCAAACCCCCCCG
ATGTTCTAGTGAAGTAAAC -> TGTTCTAGTGAAGTAAACC
GAAGCATTGTGTCATCGTC -> AAGCATTGTGTCATCGTCT
TTAATTAGAACCAGGAAAA -> TAATTAGAACCAGGAAAAC
TAATCAGCCCGGATGTCTA -> AATCAGCCCGGATGTCTAA
CACAACAAACGGAGGTCAA -> ACAACAAACGGAGGTCAAG
CTTACAACGTGCAGTTCGA -> TTACAACGTGCAGTTCGAA
ACTAGAACTCCGTTTCCCC -> CTAGAACTCCGTTTCCCCG
CCCGGATGTCTAATCGTCC -> CCGGATGTCTAATCGTCCT
TCGATAAAACTGTCGTAAA -> CGATAAAACTGTCGTAAAA
GTGGGTCCTACTGCGTGAT -> TGGGTCCTACTGCGTGATC
TACAGGGAACAGGGTGCCG -> ACAGGGAACAGGGTGCCGC
TCTATCTGGGAAGCTGCCG -> CTATCTGGGAAGCTGCCGC
GAACGCCCTTCCTTACAAC -> AACGCCCTTCCTTACAACG
AAGGGCCAACAGGACCTGA -> AGGGCCAACAGGACCTGAT
CAACGTGCAGTTCGAATAC -> AACGTGCAGTTCGAATACA
ACACAGAGCAAGAATCCGG -> CACAGAGCAAGAATCCGGA
CTACAGGGAACAGGGTGCC -> TACAGGGAACAGGGTGCCG
CCGGATGTCTAATCGCCCG -> CGGATGTCTAATCGCCCGA
AGAGTTATTGTCTCCCCCA -> GAGTTATTGTCTCCCCCAT
GACGGACCGAACTCCACAT -> ACGGACCGAACTCCACATA
CCCGGATGTCTAATCGTAA -> CCGGATGTCTAATCGTAAC
GAGGTGACGCCCTCGGTGC -> AGGTGACGCCCTCGGTGCT
CACACGCGACAGAGGCCCC -> ACACGCGACAGAGGCCCCC
CCAGTCCACCATCCAAAGT -> CAGTCCACCATCCAAAGTA
TTAATGCCGCAGCCGCCTG -> TAATGCCGCAGCCGCCTGA
AGACTCTTGTAGTGTTACA -> GACTCTTGTAGTGTTACAT
AACGCTAGTAGTGCCCATT -> ACGCTAGTAGTGCCCATTG
CTAATCGTAACCGCAAGGG -> TAATCGTAACCGCAAGGGT
TGCGACGGACCGAACTCCA -> GCGACGGACCGAACTCCAC
ACCACACGCCAATACTGTA -> CCACACGCCAATACTGTAG
ACTTTATTGTCTCCCCCAT -> CTTTATTGTCTCCCCCATA
CAAACCTCCAGCCAACTGA -> AAACCTCCAGCCAACTGAG
AAGGTTAACGCCGCGGTAT -> AGGTTAACGCCGCGGTATA
CCCGGGCACATGTACGACC -> CCGGGCACATGTACGACCT
GGATGTCTAATCGTAACCG -> GATGTCTAATCGTAACCGC
TCTCGCGCCCGGGCACATG -> CTCGCGCCCGGGCACATGT
ATTTCGCCAAACCACACGC -> TTTCGCCAAACCACACGCC
TTGAATACAGCCCGGATGT -> TGAATACAGCCCGGATGTC
TTTTGTTAGGCAGCCCGGA -> TTTGTTAGGCAGCCCGGAT
ATGCGTCTAGCTTGCTTGT -> TGCGTCTAGCTTGCTTGTT
TTCTAAGAAGGTTAACGCC -> TCTAAGAAGGTTAACGCCG
AAACCTCCAGCCAACTGAG -> AACCTCCAGCCAACTGAGT
CCGCGTAACGTGACGGCGC -> CGCGTAACGTGACGGCGCG
TCCACATATTTGGACATGC -> CCACATATTTGGACATGCC
ACCCCAACTGAATAGTATA -> CCCCAACTGAATAGTATAT
CCCCCCGCGCGGAACGGAG -> CCCCCGCGCGGAACGGAGA
AGTAATGTCGATAAAACTG -> GTAATGTCGATAAAACTGT
CCCTGCCGTCGCTGCGCGA -> CCTGCCGTCGCTGCGCGAT
GGTTTAGGTGACCCGTTGT -> GTTTAGGTGACCCGTTGTG
TCATGACTGCGCTACGGAA -> CATGACTGCGCTACGGAAC
CAAAGTAAATCCAAGGTCT -> AAAGTAAATCCAAGGTCTC
CCTATACCATTCTACAGTA -> CTATACCATTCTACAGTAA
GGAGCCTGTTTAACTGTGA -> GAGCCTGTTTAACTGTGAC
GGTCGAAATGCATGAGGAA -> GTCGAAATGCATGAGGAAG
GAGTCTTTACTGCTCTCGG -> AGTCTTTACTGCTCTCGGA
ATCGCTTCTGGCACCCGAC -> TCGCTTCTGGCACCCGACT
GCTTTTAGGCTGGGGGCGA -> CTTTTAGGCTGGGGGCGAT
TACGTAACCCCTGCCGTCG -> ACGTAACCCCTGCCGTCGC
ACAGCTCTCTTGGTTTTGG -> CAGCTCTCTTGGTTTTGGA
TACATTCCAAGCGGACTAG -> ACATTCCAAGCGGACTAGT
GGTGCCGCAAGAAGTCACA -> GTGCCGCAAGAAGTCACAC
TCCAAGCGGACTAGTTCGG -> CCAAGCGGACTAGTTCGGG
CTGGCACCCGACTCCTGAT -> TGGCACCCGACTCCTGATC
GTGAAGTAAACCCCCGAGA -> TGAAGTAAACCCCCGAGAA
GTCCTTTCTATACACTTAA -> TCCTTTCTATACACTTAAA
TAGCTGGCCGACCCACCAT -> AGCTGGCCGACCCACCATC
GGATCGCTTCTGGCACCCG -> GATCGCTTCTGGCACCCGA
TCTCTCGCGCCCGGGCACA -> CTCTCGCGCCCGGGCACAT
ACAAGTGGTAAGTTCAAAG -> CAAGTGGTAAGTTCAAAGT
TTGTTAGGCAGCCCGGATG -> TGTTAGGCAGCCCGGATGT
GGACCTGGATACCGACGGT -> GACCTGGATACCGACGGTC
TGCCGCAGCCGCCTGAAGG -> GCCGCAGCCGCCTGAAGGT
GCCTCTAAACCGACTACTG -> CCTCTAAACCGACTACTGC
ACTCACCTCGAGACCTATT -> CTCACCTCGAGACCTATTC
TCTTGCTAGGCAGGTCAAA -> CTTGCTAGGCAGGTCAAAC
GCCGACCCACCATCGCTAT -> CCGACCCACCATCGCTATC
TCCCCCATAACTTGATAAT -> CCCCCATAACTTGATAATT
TAGTGCCCATTGCACACGC -> AGTGCCCATTGCACACGCC
CCTGCCGTCGCTGCGCGAT -> CTGCCGTCGCTGCGCGATA
AACCCCCCCGCGCGGAACG -> ACCCCCCCGCGCGGAACGG
GCCCGGGCACATGTACGAC -> CCCGGGCACATGTACGACC
ATTATTGTCTCCCCCATAA -> TTATTGTCTCCCCCATAAA
TCAGCAATGCGGTGGGTCC -> CAGCAATGCGGTGGGTCCT
CGCCGCGGTATACAAAAGA -> GCCGCGGTATACAAAAGAT
TGTACGAATACAGTTGGTT -> GTACGAATACAGTTGGTTA
AAGCTTGAGAACGGTTCCA -> AGCTTGAGAACGGTTCCAT
GGGGCATGTTCTAGTGAAG -> GGGCATGTTCTAGTGAAGT
GGCTGGGGGCGATTCAGAC -> GCTGGGGGCGATTCAGACT
CTAGGCAGGTCAAACCCCC -> TAGGCAGGTCAAACCCCCC
TGTGGGAAGAATGAGCCCT -> GTGGGAAGAATGAGCCCTT
ACGCGACAGAGGCCCCCCT -> CGCGACAGAGGCCCCCCTT
GTGACCGGTTGATTTCGCC -> TGACCGGTTGATTTCGCCA
ATTAGTATATGACTCACCT -> TTAGTATATGACTCACCTC
ATGGTGCAAGGTGCTTAGT -> TGGTGCAAGGTGCTTAGTG
GTTACGAGGCAACAGGGTA -> TTACGAGGCAACAGGGTAC
TAGCTGGGGAGCCTGTTTA -> AGCTGGGGAGCCTGTTTAA
AAATCTCTACAATGGGTTT -> AATCTCTACAATGGGTTTA
CTGGAGATGGGGTAACGTC -> TGGAGATGGGGTAACGTCC
TTCCTGCCAGGACATACTT -> TCCTGCCAGGACATACTTC
CCCCGAGAAGTTTCGGCTC -> CCCGAGAAGTTTCGGCTCC
AGGCTTTTAGGCTGGGGGC -> GGCTTTTAGGCTGGGGGCG
GTCTCGGCCTCTAAACCGA -> TCTCGGCCTCTAAACCGAC
GCACCCGACTCCTGATCTG -> CACCCGACTCCTGATCTGA
GCATGTCTATTGCCGGCAC -> CATGTCTATTGCCGGCACC
TAGGCTGGCAGCCTTCGTG -> AGGCTGGCAGCCTTCGTGC
CCCCATAACTTGATAATTA -> CCCATAACTTGATAATTAC
TCCTAGGATTTGCTCACAA -> CCTAGGATTTGCTCACAAC
CAACACTTTGCGACGACCA -> AACACTTTGCGACGACCAC
AGTGTGCGCTTAAACCGAC -> GTGTGCGCTTAAACCGACT
CCCATCTTAAGACTTTTCC -> CCATCTTAAGACTTTTCCT
AGCATTGTGTCATCGTCTA -> GCATTGTGTCATCGTCTAC
CCCCCATAAGTGTAGGTAA -> CCCCATAAGTGTAGGTAAT
GTGATCCAGTCCACCATCC -> TGATCCAGTCCACCATCCA
TCAGACTCTTGTAGTGTTA -> CAGACTCTTGTAGTGTTAC
GGTCCTACTGCGTGATCCA -> GTCCTACTGCGTGATCCAG
GCGACGACCACGATTGAGT -> CGACGACCACGATTGAGTC
AGCCCCCGCAACGCTAGTA -> GCCCCCGCAACGCTAGTAG
GACAGAGGCCCCCCTTGCT -> ACAGAGGCCCCCCTTGCTC
CAACTGAGTGTGCGCTTAA -> AACTGAGTGTGCGCTTAAA
GTCGCAGAGCCACCCGAGT -> TCGCAGAGCCACCCGAGTT
GTGTAGTAAGCCTTCTCGC -> TGTAGTAAGCCTTCTCGCA
GTCAGTACCCCAACTGAAT -> TCAGTACCCCAACTGAATA
GGTTAACGCCGCGGTATAC -> GTTAACGCCGCGGTATACA
TCTACCGAAAAAAAGGGCA -> CTACCGAAAAAAAGGGCAA
GCATGTTCTAGTGAAGTAA -> CATGTTCTAGTGAAGTAAA
AGGAAAACTTGACAAGTGG -> GGAAAACTTGACAAGTGGT
CTTGTTTCTCCGGTCTGGA -> TTGTTTCTCCGGTCTGGAG
ATGCCGCAGCCGCCTGAAG -> TGCCGCAGCCGCCTGAAGG
CTAGTTCGGGTCAAGTGAC -> TAGTTCGGGTCAAGTGACT
CATGTTCTAGTGAAGTAAA -> ATGTTCTAGTGAAGTAAAC
TGAGAACGGTTCCATGTGA -> GAGAACGGTTCCATGTGAT
GCACTCCACTACAAGTCGC -> CACTCCACTACAAGTCGCA
CGCTTAAACCGACTGGTTA -> GCTTAAACCGACTGGTTAC
CAAGAAGTCACACAGTCCG -> AAGAAGTCACACAGTCCGC
CTCTTGTAGTGTTACATAT -> TCTTGTAGTGTTACATATT
CTACGGAACGCGGGGCATG -> TACGGAACGCGGGGCATGT
GATAAAACTGTCGTAAAAT -> ATAAAACTGTCGTAAAATC
ACGTGACGGCGCGAGGTCA -> CGTGACGGCGCGAGGTCAT
TTATTGTCTCCCCCATAAA -> TATTGTCTCCCCCATAAAT
ACGCTAGTAGTGCCCATTG -> CGCTAGTAGTGCCCATTGC
CTAATCGTCGGTGTAGTAA -> TAATCGTCGGTGTAGTAAG
TTCATCCGAGTACGTAACC -> TCATCCGAGTACGTAACCC
AGTTCTTAATGCCGCAGCC -> GTTCTTAATGCCGCAGCCG
TTCTCATTTTCTCAAATCA -> TCTCATTTTCTCAAATCAC
TGCCGAGCTAATCGTGCTA -> GCCGAGCTAATCGTGCTAC
AGGCAGCCCGGATGTCTAA -> GGCAGCCCGGATGTCTAAT
GTGTTACATATTCTCATTT -> TGTTACATATTCTCATTTT
GGTATACAAAAGATAGAGT -> GTATACAAAAGATAGAGTT
TGCTACATGAAATCTCTCG -> GCTACATGAAATCTCTCGC
CAACGTTCTATCTGGGAAG -> AACGTTCTATCTGGGAAGC
TGAAGTAAACCCCCGAGAA -> GAAGTAAACCCCCGAGAAG
CGTCCTTTCTATACACTTA -> GTCCTTTCTATACACTTAA
TCCGTTTCCCCGAAGCTTG -> CCGTTTCCCCGAAGCTTGA
CCACCATCCAAAGTATATG -> CACCATCCAAAGTATATGA
CACCATCGCTATCGGGACG -> ACCATCGCTATCGGGACGA
GTAAAATCTCTACAATGGG -> TAAAATCTCTACAATGGGT
ACAGGACCTGATCCCATGC -> CAGGACCTGATCCCATGCC
AGATTCAGCAATGCGGTGG -> GATTCAGCAATGCGGTGGG
CGTCCCACGCCTCGTAGTG -> GTCCCACGCCTCGTAGTGG
GGGATTACACGTCCTTTCT -> GGATTACACGTCCTTTCTA
TTTCTATACACTTAAATCA -> TTCTATACACTTAAATCAC
TGTCTCCCCCATAAGTGTA -> GTCTCCCCCATAAGTGTAG
CTGTGACACTCTTGCTAGG -> TGTGACACTCTTGCTAGGC
AGTCCGCGAACGCCCTTCC -> GTCCGCGAACGCCCTTCCT
GATTCAGCAATGCGGTGGG -> ATTCAGCAATGCGGTGGGT
AACCGACTACTGCTTTTTC -> ACCGACTACTGCTTTTTCA
GTTTCGGCTCCTATACCAT -> TTTCGGCTCCTATACCATT
AACAGGACCTGATCCCATG -> ACAGGACCTGATCCCATGC
TTAGTATATGACTCACCTC -> TAGTATATGACTCACCTCG
ATTACACGTCCTTTCTATA -> TTACACGTCCTTTCTATAC
TATCTATCTGAGTGTTTAG -> ATCTATCTGAGTGTTTAGG
CACCTCGAGACCTATTCAG -> ACCTCGAGACCTATTCAGC
CCAATACTGTAGCCGGACA -> CAATACTGTAGCCGGACAA
TATGACTCACCTCGAGACC -> ATGACTCACCTCGAGACCT
GTAACCCCTGCCGTCGCTG -> TAACCCCTGCCGTCGCTGC
TTTAGGTGACCCGTTGTGA -> TTAGGTGACCCGTTGTGAC
ATAATTACAGCCCGGATGT -> TAATTACAGCCCGGATGTC
CATCCGAGTACGTAACCCC -> ATCCGAGTACGTAACCCCT
CGCGAACGCCCTTCCTTAC -> GCGAACGCCCTTCCTTACA
TTGTCAACAGTGGAATGCC -> TGTCAACAGTGGAATGCCC
GCGGTGGGTCCTACTGCGT -> CGGTGGGTCCTACTGCGTG
CGCGACAGAGGCCCCCCTT -> GCGACAGAGGCCCCCCTTG
GAAAACTGCGACGGACCGA -> AAAACTGCGACGGACCGAA
GAACGGAGATGTGAGCTGT -> AACGGAGATGTGAGCTGTG
ACGGAACGCGGGGCATGTT -> CGGAACGCGGGGCATGTTC
CGCAACGCTAGTAGTGCCC -> GCAACGCTAGTAGTGCCCA
GTCGAAATGCATGAGGAAG -> TCGAAATGCATGAGGAAGG
ATGAAATCTCTCGCGCCCG -> TGAAATCTCTCGCGCCCGG
CCGCGCCATACGGTTCCGA -> CGCGCCATACGGTTCCGAT
TACCATTCTACAGTAATGT -> ACCATTCTACAGTAATGTC
ACTCCTAGGATTTGCTCAC -> CTCCTAGGATTTGCTCACA
GAGGAAGGCTTTTAGGCTG -> AGGAAGGCTTTTAGGCTGG
CCCATAACTTGATAATTAC -> CCATAACTTGATAATTACA
TCTTATTGTCTCCCCCATA -> CTTATTGTCTCCCCCATAA
ACCTATAGCTGGCCGACCC -> CCTATAGCTGGCCGACCCA
TGGTTCGAGGTGACGCCCT -> GGTTCGAGGTGACGCCCTC
ACTGCGACGGACCGAACTC -> CTGCGACGGACCGAACTCC
GATAGAGTTATTGTCTCCC -> ATAGAGTTATTGTCTCCCC
TCGGGTCGAAATGCATGAG -> CGGGTCGAAATGCATGAGG
TTGTCTCCCCCATAAATTT -> TGTCTCCCCCATAAATTTT
TACAATGGGTTTAGGTGAC -> ACAATGGGTTTAGGTGACC
ATGCGGTTAACGAAGGGAT -> TGCGGTTAACGAAGGGATT
AATCTCTACAATGGGTTTA -> ATCTCTACAATGGGTTTAG
TCTACAATGGGTTTAGGTG -> CTACAATGGGTTTAGGTGA
CGGTATACAAAAGATAGAG -> GGTATACAAAAGATAGAGT
TCCGCGAACGCCCTTCCTT -> CCGCGAACGCCCTTCCTTA
TACCCCAACTGAATAGTAT -> ACCCCAACTGAATAGTATA
CGACAGAGGCCCCCCTTGC -> GACAGAGGCCCCCCTTGCT
CAGCCGCCTGAAGGTACTG -> AGCCGCCTGAAGGTACTGA
GTAACGTCCGCGCCATACG -> TAACGTCCGCGCCATACGG
AGCACTAACCACACGCGAC -> GCACTAACCACACGCGACA
CATTGCACACGCCACGCCC -> ATTGCACACGCCACGCCCG
AAAACTGCGACGGACCGAA -> AAACTGCGACGGACCGAAC
AACGGAGATGTGAGCTGTG -> ACGGAGATGTGAGCTGTGT
TTCTCCGGTCTGGAGATGG -> TCTCCGGTCTGGAGATGGG
AGAGGGCGCCCCCATCTTA -> GAGGGCGCCCCCATCTTAA
AGTTTCGGCTCCTATACCA -> GTTTCGGCTCCTATACCAT
TGGGCATCCAGATTGTCAA -> GGGCATCCAGATTGTCAAC
AAGGTGCTTAGTGATGCGT -> AGGTGCTTAGTGATGCGTC
ACCGACTACTGCTTTTTCA -> CCGACTACTGCTTTTTCAT
AGTATATGACAACTAAACA -> GTATATGACAACTAAACAC
GTACTGACTTGACAGCTCT -> TACTGACTTGACAGCTCTC
CTTCCTTACAACGTGCAGT -> TTCCTTACAACGTGCAGTT
AAGAAGGTTAACGCCGCGG -> AGAAGGTTAACGCCGCGGT
CTATTGTTTACTCGGGTCG -> TATTGTTTACTCGGGTCGA
TCCACCATCCAAAGTATAT -> CCACCATCCAAAGTATATG
TAGTGATGCGTCTAGCTTG -> AGTGATGCGTCTAGCTTGC
CATGCCCTCTATTGTTTAC -> ATGCCCTCTATTGTTTACT
CGCAGCCGCCTGAAGGTAC -> GCAGCCGCCTGAAGGTACT
GTAGGTAATCAGCCCGGAT -> TAGGTAATCAGCCCGGATG
CGAGTGTTCCAATCAAGGA -> GAGTGTTCCAATCAAGGAA
GTGTCCTTAACTGCCGCGT -> TGTCCTTAACTGCCGCGTA
TATAGACGTAAGTCGTGTA -> ATAGACGTAAGTCGTGTAG
ATTTGCTCACAACAAACGG -> TTTGCTCACAACAAACGGA
ACTGCTTTTTCATGACTGC -> CTGCTTTTTCATGACTGCG
GTCTTCCCGTCCCACGCCT -> TCTTCCCGTCCCACGCCTC
CATAAGTGTAGGTAATCAG -> ATAAGTGTAGGTAATCAGC
CGCCCGCATGTCTATTGCC -> GCCCGCATGTCTATTGCCG
AACAGGGTGCCGCAAGAAG -> ACAGGGTGCCGCAAGAAGT
ACTGCGCTACGGAACGCGG -> CTGCGCTACGGAACGCGGG
AGGACATACTTCCTTTAAT -> GGACATACTTCCTTTAATT
ATAATAACTTGAATACAGC -> TAATAACTTGAATACAGCC
AGTGTTACATATTCTCATT -> GTGTTACATATTCTCATTT
GCTAGTAGTGCCCATTGCA -> CTAGTAGTGCCCATTGCAC
GTCTACCGAAAAAAAGGGC -> TCTACCGAAAAAAAGGGCA
CTTAGTAAGTGCCGAGCTA -> TTAGTAAGTGCCGAGCTAA
GGAAGCATTGTGTCATCGT -> GAAGCATTGTGTCATCGTC
TTTGGACATGCCCTCTATT -> TTGGACATGCCCTCTATTG
AGTCTTTACTGCTCTCGGA -> GTCTTTACTGCTCTCGGAA
TCGGAAGTTCATCCGAGTA -> CGGAAGTTCATCCGAGTAC
TCCTGCCAGGACATACTTC -> CCTGCCAGGACATACTTCC
GCATGAGGAAGGCTTTTAG -> CATGAGGAAGGCTTTTAGG
ATGTCTAATCGTAACCGCA -> TGTCTAATCGTAACCGCAA
GCCGCGGTATACAAAAGAT -> CCGCGGTATACAAAAGATA
GACGCCCTCGGTGCTAGCT -> ACGCCCTCGGTGCTAGCTG
AGCCGGACAACGTTCTATC -> GCCGGACAACGTTCTATCT
CTAGGATTTGCTCACAACA -> TAGGATTTGCTCACAACAA
CTACTGCTTTTTCATGACT -> TACTGCTTTTTCATGACTG
GATTGAGTCTTTACTGCTC -> ATTGAGTCTTTACTGCTCT
TGCGGTTAACGAAGGGATT -> GCGGTTAACGAAGGGATTA
GCCCTTGACAAACCTCCAG -> CCCTTGACAAACCTCCAGC
ATCGTCCTATACGTACGAT -> TCGTCCTATACGTACGATG
CCCCGCAACGCTAGTAGTG -> CCCGCAACGCTAGTAGTGC
GGTCAAGCTTTGTACGAAT -> GTCAAGCTTTGTACGAATA
ATACGGTTCCGATTAGTAT -> TACGGTTCCGATTAGTATA
ATGTGAGCTGTGTAGGCAG -> TGTGAGCTGTGTAGGCAGC
CTCGCACTCCACTACAAGT -> TCGCACTCCACTACAAGTC
CGGACTAGTTCGGGTCAAG -> GGACTAGTTCGGGTCAAGT
AGTATATGACTCACCTCGA -> GTATATGACTCACCTCGAG
GGAAAACTTGACAAGTGGT -> GAAAACTTGACAAGTGGTA
CGATAGTCACTGTGTCCTT -> GATAGTCACTGTGTCCTTA
TTACACGTCCTTTCTATAC -> TACACGTCCTTTCTATACA
TCCACTACAAGTCGCAGAG -> CCACTACAAGTCGCAGAGC
CCTCTATTGTTTACTCGGG -> CTCTATTGTTTACTCGGGT
CTCTCTTGGTTTTGGAAAA -> TCTCTTGGTTTTGGAAAAC
GCGCGGAACGGAGATGTGA -> CGCGGAACGGAGATGTGAG
GGGCATCCAGATTGTCAAC -> GGCATCCAGATTGTCAACA
GCTAGGCAGGTCAAACCCC -> CTAGGCAGGTCAAACCCCC
GACGGCGCGAGGTCATGTC -> ACGGCGCGAGGTCATGTCA
ACTAAACACAGAGCAAGAA -> CTAAACACAGAGCAAGAAT
AGCCCGGATGTCTAATCGC -> GCCCGGATGTCTAATCGCC
TGTCGTAAAATCTCTACAA -> GTCGTAAAATCTCTACAAT
CTGCCGCGTAACGTGACGG -> TGCCGCGTAACGTGACGGC
CACTGTGTCCTTAACTGCC -> ACTGTGTCCTTAACTGCCG
GGGACGAGTGTTCCAATCA -> GGACGAGTGTTCCAATCAA
AGAGGCCCCCCTTGCTCTT -> GAGGCCCCCCTTGCTCTTA
CTCTACAATGGGTTTAGGT -> TCTACAATGGGTTTAGGTG
AATTACAGCCCGGATGTCT -> ATTACAGCCCGGATGTCTA
TTACATATTCTCATTTTCT -> TACATATTCTCATTTTCTC
TACGAATACAGTTGGTTAT -> ACGAATACAGTTGGTTATG
GCATCCAGATTGTCAACAG -> CATCCAGATTGTCAACAGT
AATTATTGTCTCCCCCATA -> ATTATTGTCTCCCCCATAA
GCGGTATACAAAAGATAGA -> CGGTATACAAAAGATAGAG
ATCGTAACCGCAAGGGTTT -> TCGTAACCGCAAGGGTTTC
TTAGGCTGGGGGCGATTCA -> TAGGCTGGGGGCGATTCAG
CTCGCGCCCGGGCACATGT -> TCGCGCCCGGGCACATGTA
TACTTCCTTTAATTAGAAC -> ACTTCCTTTAATTAGAACC
AGTCGCAGAGCCACCCGAG -> GTCGCAGAGCCACCCGAGT
CCCGCGCGGAACGGAGATG -> CCGCGCGGAACGGAGATGT
CTCGGCCTCTAAACCGACT -> TCGGCCTCTAAACCGACTA
ATTGCCGGCACCTTAAACT -> TTGCCGGCACCTTAAACTC
TGCCGGCACCTTAAACTCC -> GCCGGCACCTTAAACTCCC
ATACAAAAGATAGAGTTAT -> TACAAAAGATAGAGTTATT
GCCATACGGTTCCGATTAG -> CCATACGGTTCCGATTAGT
AATCGTCCTATACGTACGA -> ATCGTCCTATACGTACGAT
TCTCGGCCTCTAAACCGAC -> CTCGGCCTCTAAACCGACT
GACCGAACTCCACATATTT -> ACCGAACTCCACATATTTG
CGAAAAAAAGGGCAACACT -> GAAAAAAAGGGCAACACTT
GAGGGCGCCCCCATCTTAA -> AGGGCGCCCCCATCTTAAG
CGCAATTATTGTCTCCCCC -> GCAATTATTGTCTCCCCCA
GTCTGGAGATGGGGTAACG -> TCTGGAGATGGGGTAACGT
ACTGCCGCGTAACGTGACG -> CTGCCGCGTAACGTGACGG
TGGGGTAACGTCCGCGCCA -> GGGGTAACGTCCGCGCCAT
CGCTAGTAGTGCCCATTGC -> GCTAGTAGTGCCCATTGCA
CTTTCTATACACTTAAATC -> TTTCTATACACTTAAATCA
TACTGCTTTTTCATGACTG -> ACTGCTTTTTCATGACTGC
TTTAATTAGAACCAGGAAA -> TTAATTAGAACCAGGAAAA
GTCTCCCCCATAATAACTT -> TCTCCCCCATAATAACTTG
CGCCATACGGTTCCGATTA -> GCCATACGGTTCCGATTAG
TTCCAAGCGGACTAGTTCG -> TCCAAGCGGACTAGTTCGG
CCTATAGCTGGCCGACCCA -> CTATAGCTGGCCGACCCAC
CCCATAATAACTTGAATAC -> CCATAATAACTTGAATACA
CCGAGAAGTTTCGGCTCCT -> CGAGAAGTTTCGGCTCCTA
GGCACATGTACGACCTATA -> GCACATGTACGACCTATAG
CCTGATCCCATGCCTGTGA -> CTGATCCCATGCCTGTGAC
ACAATAGAAGTGAGCCAAT -> CAATAGAAGTGAGCCAATA
AGTGATGCGTCTAGCTTGC -> GTGATGCGTCTAGCTTGCT
TCACACAGTCCGCGAACGC -> CACACAGTCCGCGAACGCC
TACCTGTGGGAAGAATGAG -> ACCTGTGGGAAGAATGAGC
GACCCACCATCGCTATCGG -> ACCCACCATCGCTATCGGG
CTGCCGTCGCTGCGCGATA -> TGCCGTCGCTGCGCGATAG
GGAGATGTGAGCTGTGTAG -> GAGATGTGAGCTGTGTAGG
TCCCAATAAGTCTTCCCGT -> CCCAATAAGTCTTCCCGTC
AAACCGACTGGTTACGAGG -> AACCGACTGGTTACGAGGC
TATGGGCATCCAGATTGTC -> ATGGGCATCCAGATTGTCA
TTCTACAGTAATGTCGATA -> TCTACAGTAATGTCGATAA
GTACATTCTAAGAAGGTTA -> TACATTCTAAGAAGGTTAA
TTGTACGAATACAGTTGGT -> TGTACGAATACAGTTGGTT
AACACAGAGCAAGAATCCG -> ACACAGAGCAAGAATCCGG
CGGAGGTCAAGCTTTGTAC -> GGAGGTCAAGCTTTGTACG
AATACAATAGAAGTGAGCC -> ATACAATAGAAGTGAGCCA
TTCTGGCACCCGACTCCTG -> TCTGGCACCCGACTCCTGA
CCGCGCGGAACGGAGATGT -> CGCGCGGAACGGAGATGTG
TGTAGCCGGACAACGTTCT -> GTAGCCGGACAACGTTCTA
GGTTACTGCTATAGACGTA -> GTTACTGCTATAGACGTAA
TGCTGGATAGAAACTGAGC -> GCTGGATAGAAACTGAGCC
ACGTAACCCCTGCCGTCGC -> CGTAACCCCTGCCGTCGCT
TCACTCCTAGGATTTGCTC -> CACTCCTAGGATTTGCTCA
GTGGGAAGAATGAGCCCTT -> TGGGAAGAATGAGCCCTTG
CGAGAAGTTTCGGCTCCTA -> GAGAAGTTTCGGCTCCTAT
TGACCGGTTGATTTCGCCA -> GACCGGTTGATTTCGCCAA
TGTAGTGTTACATATTCTC -> GTAGTGTTACATATTCTCA
CCGAGTTCTTAATGCCGCA -> CGAGTTCTTAATGCCGCAG
CGCCCGAGATTCAGCAATG -> GCCCGAGATTCAGCAATGC
TCCTTACAACGTGCAGTTC -> CCTTACAACGTGCAGTTCG
ATCTATCTGAGTGTTTAGG -> TCTATCTGAGTGTTTAGGC
AGTTCGAATACAATAGAAG -> GTTCGAATACAATAGAAGT
CCTTGACAAACCTCCAGCC -> CTTGACAAACCTCCAGCCA
GCTCACAACAAACGGAGGT -> CTCACAACAAACGGAGGTC
CGATTGAGTCTTTACTGCT -> GATTGAGTCTTTACTGCTC
AGAACGGTTCCATGTGATT -> GAACGGTTCCATGTGATTT
GGATAGAAACTGAGCCCCC -> GATAGAAACTGAGCCCCCG
CGCCTGAAGGTACTGACTT -> GCCTGAAGGTACTGACTTG
CGCCAAACCACACGCCAAT -> GCCAAACCACACGCCAATA
TGTGTCCTTAACTGCCGCG -> GTGTCCTTAACTGCCGCGT
GACGGTCTAATGCGGTTAA -> ACGGTCTAATGCGGTTAAC
CATTCTAAGAAGGTTAACG -> ATTCTAAGAAGGTTAACGC
TGAAGGTACTGACTTGACA -> GAAGGTACTGACTTGACAG
CTCCTAGGATTTGCTCACA -> TCCTAGGATTTGCTCACAA
GACATGCCCTCTATTGTTT -> ACATGCCCTCTATTGTTTA
CTATACCATTCTACAGTAA -> TATACCATTCTACAGTAAT
CGGCTCCTATACCATTCTA -> GGCTCCTATACCATTCTAC
GCTGGCAGCCTTCGTGCTG -> CTGGCAGCCTTCGTGCTGG
CAGGTCAAACCCCCCCGCG -> AGGTCAAACCCCCCCGCGC
ACGAGTGTTCCAATCAAGG -> CGAGTGTTCCAATCAAGGA
ATGGGTTTAGGTGACCCGT -> TGGGTTTAGGTGACCCGTT
ACATTCCAAGCGGACTAGT -> CATTCCAAGCGGACTAGTT
ATCTTAAGACTTTTCCTGC -> TCTTAAGACTTTTCCTGCC
TACAGCCCGGATGTCTAAT -> ACAGCCCGGATGTCTAATC, ACAGCCCGGATGTCTAATC
TTTCATGACTGCGCTACGG -> TTCATGACTGCGCTACGGA
ATAAATTTTGTTAGGCAGC -> TAAATTTTGTTAGGCAGCC
TTTAACTGTGACCGGTTGA -> TTAACTGTGACCGGTTGAT
AATCCAAGGTCTCGGCCTC -> ATCCAAGGTCTCGGCCTCT
AACGTGACGGCGCGAGGTC -> ACGTGACGGCGCGAGGTCA
TAGAGTTATTGTCTCCCCC -> AGAGTTATTGTCTCCCCCA
GCAGCCCGGATGTCTAATC -> CAGCCCGGATGTCTAATCG
ACAAAAGATAGAGTTATTG -> CAAAAGATAGAGTTATTGT
AACCCCTGCCGTCGCTGCG -> ACCCCTGCCGTCGCTGCGC
TGTGACACTCTTGCTAGGC -> GTGACACTCTTGCTAGGCA
CTCTAAACCGACTACTGCT -> TCTAAACCGACTACTGCTT
ACCATTCTACAGTAATGTC -> CCATTCTACAGTAATGTCG
GCCGCGTAACGTGACGGCG -> CCGCGTAACGTGACGGCGC
AGTGTTTAGGCTGGCAGCC -> GTGTTTAGGCTGGCAGCCT
CAAAGTATATGACAACTAA -> AAAGTATATGACAACTAAA
ACGAAGGGATTACACGTCC -> CGAAGGGATTACACGTCCT
AATTTTGTTAGGCAGCCCG -> ATTTTGTTAGGCAGCCCGG
AAAAAAGGGCAACACTTTG -> AAAAAGGGCAACACTTTGC
GGGCATGTTCTAGTGAAGT -> GGCATGTTCTAGTGAAGTA
TGCAAGGTGCTTAGTGATG -> GCAAGGTGCTTAGTGATGC
TTAAAGGGCCAACAGGACC -> TAAAGGGCCAACAGGACCT
GGTAACGTCCGCGCCATAC -> GTAACGTCCGCGCCATACG
GACTCCTGATCTGACAAGG -> ACTCCTGATCTGACAAGGA
CCACACGCCAATACTGTAG -> CACACGCCAATACTGTAGC
ATATGACAACTAAACACAG -> TATGACAACTAAACACAGA
TAAACTCCCAATAAGTCTT -> AAACTCCCAATAAGTCTTC
TTTACTCGGGTCGAAATGC -> TTACTCGGGTCGAAATGCA
CTCTCGGAAGTTCATCCGA -> TCTCGGAAGTTCATCCGAG
ACGATGGTGCAAGGTGCTT -> CGATGGTGCAAGGTGCTTA
GGCACCCGACTCCTGATCT -> GCACCCGACTCCTGATCTG
CGGATGTCTAATCGTCGGT -> GGATGTCTAATCGTCGGTG
TAAGTCGTGTAGAGGGCGC -> AAGTCGTGTAGAGGGCGCC
ACTGAATAGTATATCTATC -> CTGAATAGTATATCTATCT
CTGTAGCCGGACAACGTTC -> TGTAGCCGGACAACGTTCT
GCGGGGCATGTTCTAGTGA -> CGGGGCATGTTCTAGTGAA
TTCAGACTCTTGTAGTGTT -> TCAGACTCTTGTAGTGTTA
TAGGTAATCAGCCCGGATG -> AGGTAATCAGCCCGGATGT
ACACGCCACGCCCGCATGT -> CACGCCACGCCCGCATGTC
GCCCTTCCTTACAACGTGC -> CCCTTCCTTACAACGTGCA
TCTATTGTTTACTCGGGTC -> CTATTGTTTACTCGGGTCG
AAGCTGCCGCAATTATTGT -> AGCTGCCGCAATTATTGTC
ATCGTCTACCGAAAAAAAG -> TCGTCTACCGAAAAAAAGG
ACTTGAATACAGCCCGGAT -> CTTGAATACAGCCCGGATG
CCACGATTGAGTCTTTACT -> CACGATTGAGTCTTTACTG
ACCATCGCTATCGGGACGA -> CCATCGCTATCGGGACGAG
AGTGAGCCAATAGTACATT -> GTGAGCCAATAGTACATTC
GGATGTCTAATCGTCGGTG -> GATGTCTAATCGTCGGTGT
TAGAAACTGAGCCCCCGCA -> AGAAACTGAGCCCCCGCAA
GTATATGACTCACCTCGAG -> TATATGACTCACCTCGAGA
AACTGAATAGTATATCTAT -> ACTGAATAGTATATCTATC
CCGAAGCTTGAGAACGGTT -> CGAAGCTTGAGAACGGTTC
GAGTGTGCGCTTAAACCGA -> AGTGTGCGCTTAAACCGAC
CTCGAGACCTATTCAGCTA -> TCGAGACCTATTCAGCTAA
ACAGCCCGGATGTCTAATC -> CAGCCCGGATGTCTAATCG, CAGCCCGGATGTCTAATCG
GCTCTCGGAAGTTCATCCG -> CTCTCGGAAGTTCATCCGA
AACTGAGCCCCCGCAACGC -> ACTGAGCCCCCGCAACGCT
CTACCTGTGGGAAGAATGA -> TACCTGTGGGAAGAATGAG
CGCCCCCATCTTAAGACTT -> GCCCCCATCTTAAGACTTT
ATACAGCCCGGATGTCTAA -> TACAGCCCGGATGTCTAAT
TAACTGCCGCGTAACGTGA -> AACTGCCGCGTAACGTGAC
AAGGTACTGACTTGACAGC -> AGGTACTGACTTGACAGCT
GAGTGTTTAGGCTGGCAGC -> AGTGTTTAGGCTGGCAGCC
TGCCAGGACATACTTCCTT -> GCCAGGACATACTTCCTTT
TGGACATGCCCTCTATTGT -> GGACATGCCCTCTATTGTT
GTCCGCGAACGCCCTTCCT -> TCCGCGAACGCCCTTCCTT
CATATTTGGACATGCCCTC -> ATATTTGGACATGCCCTCT
AACTCCGTTTCCCCGAAGC -> ACTCCGTTTCCCCGAAGCT
AAGCGGACTAGTTCGGGTC -> AGCGGACTAGTTCGGGTCA
CGAGGTCATGTCAGTACCC -> GAGGTCATGTCAGTACCCC
CGCAGAGCCACCCGAGTTC -> GCAGAGCCACCCGAGTTCT
TGCCGTCGCTGCGCGATAG -> GCCGTCGCTGCGCGATAGT
CCTTTAATTAGAACCAGGA -> CTTTAATTAGAACCAGGAA
CCTCCAGCCAACTGAGTGT -> CTCCAGCCAACTGAGTGTG
TAACTGTGACCGGTTGATT -> AACTGTGACCGGTTGATTT
CCTGTGGGAAGAATGAGCC -> CTGTGGGAAGAATGAGCCC
GCACACGCCACGCCCGCAT -> CACACGCCACGCCCGCATG
GGTCATGTCAGTACCCCAA -> GTCATGTCAGTACCCCAAC
CCGCGGTATACAAAAGATA -> CGCGGTATACAAAAGATAG
CTATTGCCGGCACCTTAAA -> TATTGCCGGCACCTTAAAC
AATCGTGCTACATGAAATC -> ATCGTGCTACATGAAATCT
GACTTAGTAAGTGCCGAGC -> ACTTAGTAAGTGCCGAGCT
TCTGGGAAGCTGCCGCAAT -> CTGGGAAGCTGCCGCAATT
GAAGCTGCCGCAATTATTG -> AAGCTGCCGCAATTATTGT
ATCTCTCGCGCCCGGGCAC -> TCTCTCGCGCCCGGGCACA
CCCCAACTGAATAGTATAT -> CCCAACTGAATAGTATATC
GAGAACGGTTCCATGTGAT -> AGAACGGTTCCATGTGATT
CAATAGAAGTGAGCCAATA -> AATAGAAGTGAGCCAATAG
TTCTCAAATCACTCCTAGG -> TCTCAAATCACTCCTAGGA
GACTTTTCCTGCCAGGACA -> ACTTTTCCTGCCAGGACAT
AGGTGACGCCCTCGGTGCT -> GGTGACGCCCTCGGTGCTA
TCGTGCTACATGAAATCTC -> CGTGCTACATGAAATCTCT
TAATTAGAACCAGGAAAAC -> AATTAGAACCAGGAAAACT
GCCTTCTCGCACTCCACTA -> CCTTCTCGCACTCCACTAC
AACTGTGACCGGTTGATTT -> ACTGTGACCGGTTGATTTC
ACACGCCAATACTGTAGCC -> CACGCCAATACTGTAGCCG
GATTTCGCCAAACCACACG -> ATTTCGCCAAACCACACGC
TACGAGGCAACAGGGTACT -> ACGAGGCAACAGGGTACTA
CATCCAGATTGTCAACAGT -> ATCCAGATTGTCAACAGTG
GGGCGATTCAGACTCTTGT -> GGCGATTCAGACTCTTGTA
TCAAAGTAAATCCAAGGTC -> CAAAGTAAATCCAAGGTCT
AAATCACTACATTCCAAGC -> AATCACTACATTCCAAGCG
TATTCTCATTTTCTCAAAT -> ATTCTCATTTTCTCAAATC
TACTGACTTGACAGCTCTC -> ACTGACTTGACAGCTCTCT
ATCGTGCTACATGAAATCT -> TCGTGCTACATGAAATCTC
CACGATTGAGTCTTTACTG -> ACGATTGAGTCTTTACTGC
ACGAATACAGTTGGTTATG -> CGAATACAGTTGGTTATGG
GGATTACACGTCCTTTCTA -> GATTACACGTCCTTTCTAT
TCATTTTCTCAAATCACTC -> CATTTTCTCAAATCACTCC
GATGTCTAATCGTCCTATA -> ATGTCTAATCGTCCTATAC
CCACGCCCGCATGTCTATT -> CACGCCCGCATGTCTATTG
ACAGAGGCCCCCCTTGCTC -> CAGAGGCCCCCCTTGCTCT
GTTTAGGTGACCCGTTGTG -> TTTAGGTGACCCGTTGTGA
ACTGAGTGTGCGCTTAAAC -> CTGAGTGTGCGCTTAAACC
GAGCTGTGTAGGCAGCACT -> AGCTGTGTAGGCAGCACTA
AGATTGTCAACAGTGGAAT -> GATTGTCAACAGTGGAATG
CTGCCAGGACATACTTCCT -> TGCCAGGACATACTTCCTT
CCATAATAACTTGAATACA -> CATAATAACTTGAATACAG
GCCGGCACCTTAAACTCCC -> CCGGCACCTTAAACTCCCA
CTGCTCTCGGAAGTTCATC -> TGCTCTCGGAAGTTCATCC
GTACCCCAACTGAATAGTA -> TACCCCAACTGAATAGTAT
TATACCATTCTACAGTAAT -> ATACCATTCTACAGTAATG
CGACCCACCATCGCTATCG -> GACCCACCATCGCTATCGG
AAAGTAAATCCAAGGTCTC -> AAGTAAATCCAAGGTCTCG
TTCCCGTCCCACGCCTCGT -> TCCCGTCCCACGCCTCGTA
ACTTAGTAAGTGCCGAGCT -> CTTAGTAAGTGCCGAGCTA
CGGATGTCTAATCGTAACC -> GGATGTCTAATCGTAACCG
TCTTTACTGCTCTCGGAAG -> CTTTACTGCTCTCGGAAGT
GCCGCCTGAAGGTACTGAC -> CCGCCTGAAGGTACTGACT
CTGAGTGTTTAGGCTGGCA -> TGAGTGTTTAGGCTGGCAG
ACGTTCTATCTGGGAAGCT -> CGTTCTATCTGGGAAGCTG
TCTCGCACTCCACTACAAG -> CTCGCACTCCACTACAAGT
GGCGCCCCCATCTTAAGAC -> GCGCCCCCATCTTAAGACT
GTGAGCTGTGTAGGCAGCA -> TGAGCTGTGTAGGCAGCAC
ATTCTACAGTAATGTCGAT -> TTCTACAGTAATGTCGATA
ACCTGTGGGAAGAATGAGC -> CCTGTGGGAAGAATGAGCC
CCCGGATGTCTAATCGTCG -> CCGGATGTCTAATCGTCGG
GTTTAACTGTGACCGGTTG -> TTTAACTGTGACCGGTTGA
AGCAAGAATCCGGATCGCT -> GCAAGAATCCGGATCGCTT
ATGAACTAGAACTCCGTTT -> TGAACTAGAACTCCGTTTC
GCCTGAAGGTACTGACTTG -> CCTGAAGGTACTGACTTGA
TTTTCCTGCCAGGACATAC -> TTTCCTGCCAGGACATACT
CTCCCCCATAATAACTTGA -> TCCCCCATAATAACTTGAA
CGAATACAGTTGGTTATGG -> GAATACAGTTGGTTATGGG
ATCACTACATTCCAAGCGG -> TCACTACATTCCAAGCGGA
TGGAGATGGGGTAACGTCC -> GGAGATGGGGTAACGTCCG
TGTCAACAGTGGAATGCCC -> GTCAACAGTGGAATGCCCT
ATCGTCGGTGTAGTAAGCC -> TCGTCGGTGTAGTAAGCCT
CACCATCCAAAGTATATGA -> ACCATCCAAAGTATATGAC
AAGTAAACCCCCGAGAAGT -> AGTAAACCCCCGAGAAGTT
CCCTCGGTGCTAGCTGGGG -> CCTCGGTGCTAGCTGGGGA
CTACATGAAATCTCTCGCG -> TACATGAAATCTCTCGCGC
ACGCCTCGTAGTGGCACTA -> CGCCTCGTAGTGGCACTAC
CTGACTTGACAGCTCTCTT -> TGACTTGACAGCTCTCTTG
TTAGTAAGTGCCGAGCTAA -> TAGTAAGTGCCGAGCTAAT
GACTGCGCTACGGAACGCG -> ACTGCGCTACGGAACGCGG
AATCACTACATTCCAAGCG -> ATCACTACATTCCAAGCGG
GTTATGGGCATCCAGATTG -> TTATGGGCATCCAGATTGT
CGCGCCCGGGCACATGTAC -> GCGCCCGGGCACATGTACG
GTAGTGTTACATATTCTCA -> TAGTGTTACATATTCTCAT
GGATGTCTAATCGCCCGAG -> GATGTCTAATCGCCCGAGA
GGGGTAACGTCCGCGCCAT -> GGGTAACGTCCGCGCCATA
TTGCACACGCCACGCCCGC -> TGCACACGCCACGCCCGCA
TCTAATGCGGTTAACGAAG -> CTAATGCGGTTAACGAAGG
ATACGTACGATGGTGCAAG -> TACGTACGATGGTGCAAGG
AAGTCACACAGTCCGCGAA -> AGTCACACAGTCCGCGAAC
CGCATGTCTATTGCCGGCA -> GCATGTCTATTGCCGGCAC
AAGCATTGTGTCATCGTCT -> AGCATTGTGTCATCGTCTA
CCCCATAAGTGTAGGTAAT -> CCCATAAGTGTAGGTAATC
AGCCACCCGAGTTCTTAAT -> GCCACCCGAGTTCTTAATG
CTTCTATCTACCTGTGGGA -> TTCTATCTACCTGTGGGAA
GACCGGTTGATTTCGCCAA -> ACCGGTTGATTTCGCCAAA
GCGCTTAAACCGACTGGTT -> CGCTTAAACCGACTGGTTA
AGGATTTGCTCACAACAAA -> GGATTTGCTCACAACAAAC
GTAGTAAGCCTTCTCGCAC -> TAGTAAGCCTTCTCGCACT
TTACTCGGGTCGAAATGCA -> TACTCGGGTCGAAATGCAT
CCGGATGTCTAATCGTAAC -> CGGATGTCTAATCGTAACC
GTAAGTGCCGAGCTAATCG -> TAAGTGCCGAGCTAATCGT
ACCCCCCCGCGCGGAACGG -> CCCCCCCGCGCGGAACGGA
TGCTTTTTCATGACTGCGC -> GCTTTTTCATGACTGCGCT
TAGCCGGACAACGTTCTAT -> AGCCGGACAACGTTCTATC
ATAACTTGAATACAGCCCG -> TAACTTGAATACAGCCCGG
TCTAAACCGACTACTGCTT -> CTAAACCGACTACTGCTTT
TATACGTACGATGGTGCAA -> ATACGTACGATGGTGCAAG
TAGTGGCACTACAGGGAAC -> AGTGGCACTACAGGGAACA
ATTGTCTCCCCCATAATAA -> TTGTCTCCCCCATAATAAC
GACTTGACAGCTCTCTTGG -> ACTTGACAGCTCTCTTGGT
CACGTCCTTTCTATACACT -> ACGTCCTTTCTATACACTT
CTGTGGGAAGAATGAGCCC -> TGTGGGAAGAATGAGCCCT
GTTAACGAAGGGATTACAC -> TTAACGAAGGGATTACACG
CCGACTACTGCTTTTTCAT -> CGACTACTGCTTTTTCATG
TCCGCGCCATACGGTTCCG -> CCGCGCCATACGGTTCCGA
CCAAGGTCTCGGCCTCTAA -> CAAGGTCTCGGCCTCTAAA
TATTTGGACATGCCCTCTA -> ATTTGGACATGCCCTCTAT
CGAGTACGTAACCCCTGCC -> GAGTACGTAACCCCTGCCG
CTAGAACTCCGTTTCCCCG -> TAGAACTCCGTTTCCCCGA
GTTCCATGTGATTTAAAGG -> TTCCATGTGATTTAAAGGG
TACAATAGAAGTGAGCCAA -> ACAATAGAAGTGAGCCAAT
TCGTCGGTGTAGTAAGCCT -> CGTCGGTGTAGTAAGCCTT
GCAAGGGTTTCGGTTACTG -> CAAGGGTTTCGGTTACTGC
CGGACAACGTTCTATCTGG -> GGACAACGTTCTATCTGGG
GCAAGAAGTCACACAGTCC -> CAAGAAGTCACACAGTCCG
CGTGATCCAGTCCACCATC -> GTGATCCAGTCCACCATCC
AGGCAACAGGGTACTATGA -> GGCAACAGGGTACTATGAA
GAACTCCACATATTTGGAC -> AACTCCACATATTTGGACA
GTGCAGTTCGAATACAATA -> TGCAGTTCGAATACAATAG
CTATACGTACGATGGTGCA -> TATACGTACGATGGTGCAA
AATGCGGTGGGTCCTACTG -> ATGCGGTGGGTCCTACTGC
CACGCCTCGTAGTGGCACT -> ACGCCTCGTAGTGGCACTA
CAAGCGGACTAGTTCGGGT -> AAGCGGACTAGTTCGGGTC
CATTCCAAGCGGACTAGTT -> ATTCCAAGCGGACTAGTTC
ACTGTGACCGGTTGATTTC -> CTGTGACCGGTTGATTTCG
GGAACAGGGTGCCGCAAGA -> GAACAGGGTGCCGCAAGAA
GCCCTCGGTGCTAGCTGGG -> CCCTCGGTGCTAGCTGGGG
GTAGTGGCACTACAGGGAA -> TAGTGGCACTACAGGGAAC
CTGAGCCCCCGCAACGCTA -> TGAGCCCCCGCAACGCTAG
TGTTTAACTGTGACCGGTT -> GTTTAACTGTGACCGGTTG
TTATTGTCTCCCCCATAAT -> TATTGTCTCCCCCATAATA
GAGGTCATGTCAGTACCCC -> AGGTCATGTCAGTACCCCA
CCTCGAGACCTATTCAGCT -> CTCGAGACCTATTCAGCTA
ACGCGGGGCATGTTCTAGT -> CGCGGGGCATGTTCTAGTG
ACACGCGACAGAGGCCCCC -> CACGCGACAGAGGCCCCCC
CACGCCACGCCCGCATGTC -> ACGCCACGCCCGCATGTCT
CTAAACACAGAGCAAGAAT -> TAAACACAGAGCAAGAATC
CCGACCCACCATCGCTATC -> CGACCCACCATCGCTATCG
AGTAAACCCCCGAGAAGTT -> GTAAACCCCCGAGAAGTTT
TCTCATTTTCTCAAATCAC -> CTCATTTTCTCAAATCACT
CCGCAAGGGTTTCGGTTAC -> CGCAAGGGTTTCGGTTACT
CATTTTCTCAAATCACTCC -> ATTTTCTCAAATCACTCCT
AACTGAGTGTGCGCTTAAA -> ACTGAGTGTGCGCTTAAAC
ATTTAAAGGGCCAACAGGA -> TTTAAAGGGCCAACAGGAC
GGTTCCGATTAGTATATGA -> GTTCCGATTAGTATATGAC
ATCGCCCGAGATTCAGCAA -> TCGCCCGAGATTCAGCAAT
ATTCCAAGCGGACTAGTTC -> TTCCAAGCGGACTAGTTCG
GGTTGATTTCGCCAAACCA -> GTTGATTTCGCCAAACCAC
AGTGGTAAGTTCAAAGTAA -> GTGGTAAGTTCAAAGTAAA
GGAAGAATGAGCCCTTGAA -> GAAGAATGAGCCCTTGAAT
TAGTATATCTATCTGAGTG -> AGTATATCTATCTGAGTGT
CCCATTGCACACGCCACGC -> CCATTGCACACGCCACGCC
ACGACCACGATTGAGTCTT -> CGACCACGATTGAGTCTTT
TACCGAAAAAAAGGGCAAC -> ACCGAAAAAAAGGGCAACA
TCTTCCCGTCCCACGCCTC -> CTTCCCGTCCCACGCCTCG
AACCGCAAGGGTTTCGGTT -> ACCGCAAGGGTTTCGGTTA
TTTGCTCACAACAAACGGA -> TTGCTCACAACAAACGGAG
GATGGGGTAACGTCCGCGC -> ATGGGGTAACGTCCGCGCC
AATACAGCCCGGATGTCTA -> ATACAGCCCGGATGTCTAA
TCGGCCTCTAAACCGACTA -> CGGCCTCTAAACCGACTAC
CATTCTACAGTAATGTCGA -> ATTCTACAGTAATGTCGAT
ATTCAGCAATGCGGTGGGT -> TTCAGCAATGCGGTGGGTC
TCCAAGGTCTCGGCCTCTA -> CCAAGGTCTCGGCCTCTAA
TCAGTACCCCAACTGAATA -> CAGTACCCCAACTGAATAG
CTGATCTGACAAGGACCTG -> TGATCTGACAAGGACCTGG
TAACGTCCGCGCCATACGG -> AACGTCCGCGCCATACGGT
GAGACCTATTCAGCTAATC -> AGACCTATTCAGCTAATCT
CGACGGACCGAACTCCACA -> GACGGACCGAACTCCACAT
ACGGTCTAATGCGGTTAAC -> CGGTCTAATGCGGTTAACG
TTTAAAGGGCCAACAGGAC -> TTAAAGGGCCAACAGGACC
GTCCTACTGCGTGATCCAG -> TCCTACTGCGTGATCCAGT
TCGGTTACTGCTATAGACG -> CGGTTACTGCTATAGACGT
ACATGAAATCTCTCGCGCC -> CATGAAATCTCTCGCGCCC
GGACGAGTGTTCCAATCAA -> GACGAGTGTTCCAATCAAG
ATTGAGTCTTTACTGCTCT -> TTGAGTCTTTACTGCTCTC
CAGTGGAATGCCCTTGACA -> AGTGGAATGCCCTTGACAA
GAATGCCCTTGACAAACCT -> AATGCCCTTGACAAACCTC
AAGTGACTTAGTAAGTGCC -> AGTGACTTAGTAAGTGCCG
CTACTGCGTGATCCAGTCC -> TACTGCGTGATCCAGTCCA
GGTTCGAGGTGACGCCCTC -> GTTCGAGGTGACGCCCTCG
CTCACAACAAACGGAGGTC -> TCACAACAAACGGAGGTCA
CCCTTCCTTACAACGTGCA -> CCTTCCTTACAACGTGCAG
TGAGTGTGCGCTTAAACCG -> GAGTGTGCGCTTAAACCGA
ACTCCGTTTCCCCGAAGCT -> CTCCGTTTCCCCGAAGCTT
AAGGTCTCGGCCTCTAAAC -> AGGTCTCGGCCTCTAAACC
TCGGGACGAGTGTTCCAAT -> CGGGACGAGTGTTCCAATC
CCTATTCAGCTAATCTCCT -> CTATTCAGCTAATCTCCTT
CGTAAGTCGTGTAGAGGGC -> GTAAGTCGTGTAGAGGGCG
CGGAGATGTGAGCTGTGTA -> GGAGATGTGAGCTGTGTAG
TAACGTGACGGCGCGAGGT -> AACGTGACGGCGCGAGGTC
TGCTCTTATTGTCTCCCCC -> GCTCTTATTGTCTCCCCCA
TAGTATATGACTCACCTCG -> AGTATATGACTCACCTCGA
GCTGGGGAGCCTGTTTAAC -> CTGGGGAGCCTGTTTAACT
CCCCATAAATTTTGTTAGG -> CCCATAAATTTTGTTAGGC
GAGATGTGAGCTGTGTAGG -> AGATGTGAGCTGTGTAGGC
AGGCTGGCAGCCTTCGTGC -> GGCTGGCAGCCTTCGTGCT
CTACATTCCAAGCGGACTA -> TACATTCCAAGCGGACTAG
ACTCCTGATCTGACAAGGA -> CTCCTGATCTGACAAGGAC
CCACGCCTCGTAGTGGCAC -> CACGCCTCGTAGTGGCACT
ACGGACCGAACTCCACATA -> CGGACCGAACTCCACATAT
TGTGATTTAAAGGGCCAAC -> GTGATTTAAAGGGCCAACA
TAATCGTAACCGCAAGGGT -> AATCGTAACCGCAAGGGTT
CGCGATAGTCACTGTGTCC -> GCGATAGTCACTGTGTCCT
AACTGCCGCGTAACGTGAC -> ACTGCCGCGTAACGTGACG
GATAGAAACTGAGCCCCCG -> ATAGAAACTGAGCCCCCGC
GCCGCAAGAAGTCACACAG -> CCGCAAGAAGTCACACAGT
GCAACAGGGTACTATGAAC -> CAACAGGGTACTATGAACT
CCGGTTGATTTCGCCAAAC -> CGGTTGATTTCGCCAAACC
CCTGTGACACTCTTGCTAG -> CTGTGACACTCTTGCTAGG
AGCTCTCTTGGTTTTGGAA -> GCTCTCTTGGTTTTGGAAA
GGACCTGATCCCATGCCTG -> GACCTGATCCCATGCCTGT
TTACTGCTATAGACGTAAG -> TACTGCTATAGACGTAAGT
CGGAACGCGGGGCATGTTC -> GGAACGCGGGGCATGTTCT
GTATATCTATCTGAGTGTT -> TATATCTATCTGAGTGTTT
GAACGCGGGGCATGTTCTA -> AACGCGGGGCATGTTCTAG
GCAAGAATCCGGATCGCTT -> CAAGAATCCGGATCGCTTC
TGAGGAAGGCTTTTAGGCT -> GAGGAAGGCTTTTAGGCTG
GACTACTGCTTTTTCATGA -> ACTACTGCTTTTTCATGAC
TGCGACGACCACGATTGAG -> GCGACGACCACGATTGAGT
CGCGTAACGTGACGGCGCG -> GCGTAACGTGACGGCGCGA
GAGCTAATCGTGCTACATG -> AGCTAATCGTGCTACATGA
TAAGCCTTCTCGCACTCCA -> AAGCCTTCTCGCACTCCAC
CACGCCCGCATGTCTATTG -> ACGCCCGCATGTCTATTGC
ATGTACGACCTATAGCTGG -> TGTACGACCTATAGCTGGC
TAACGAAGGGATTACACGT -> AACGAAGGGATTACACGTC
TCGAATACAATAGAAGTGA -> CGAATACAATAGAAGTGAG
GACCACGATTGAGTCTTTA -> ACCACGATTGAGTCTTTAC
TCTAATCGTAACCGCAAGG -> CTAATCGTAACCGCAAGGG
TTGCGACGACCACGATTGA -> TGCGACGACCACGATTGAG
GTGAGCCAATAGTACATTC -> TGAGCCAATAGTACATTCT
CCGCCTGAAGGTACTGACT -> CGCCTGAAGGTACTGACTT
GTGACCCGTTGTGACTTTA -> TGACCCGTTGTGACTTTAT
GCTGGCCGACCCACCATCG -> CTGGCCGACCCACCATCGC
CTACAAGTCGCAGAGCCAC -> TACAAGTCGCAGAGCCACC
GCTAATCTCCTTCTATCTA -> CTAATCTCCTTCTATCTAC
AAGTATATGACAACTAAAC -> AGTATATGACAACTAAACA
CCATGCCTGTGACACTCTT -> CATGCCTGTGACACTCTTG
AGTGTAGGTAATCAGCCCG -> GTGTAGGTAATCAGCCCGG
CCTACTGCGTGATCCAGTC -> CTACTGCGTGATCCAGTCC
ACCCCTGCCGTCGCTGCGC -> CCCCTGCCGTCGCTGCGCG
CTAGCTTGCTTGTTTCTCC -> TAGCTTGCTTGTTTCTCCG
AAAAAGGGCAACACTTTGC -> AAAAGGGCAACACTTTGCG
CCGCAACGCTAGTAGTGCC -> CGCAACGCTAGTAGTGCCC
GAATACAATAGAAGTGAGC -> AATACAATAGAAGTGAGCC
TTAAGACTTTTCCTGCCAG -> TAAGACTTTTCCTGCCAGG
GGCTCCTATACCATTCTAC -> GCTCCTATACCATTCTACA
ACGACCTATAGCTGGCCGA -> CGACCTATAGCTGGCCGAC
CTCCAGCCAACTGAGTGTG -> TCCAGCCAACTGAGTGTGC
CAGGACATACTTCCTTTAA -> AGGACATACTTCCTTTAAT
GTTCTATCTGGGAAGCTGC -> TTCTATCTGGGAAGCTGCC
TCTTAAGACTTTTCCTGCC -> CTTAAGACTTTTCCTGCCA
TAGAACCAGGAAAACTTGA -> AGAACCAGGAAAACTTGAC
ATAAGTCTTCCCGTCCCAC -> TAAGTCTTCCCGTCCCACG
ACAGTCCGCGAACGCCCTT -> CAGTCCGCGAACGCCCTTC
CGCGGTATACAAAAGATAG -> GCGGTATACAAAAGATAGA
CATGCCTGTGACACTCTTG -> ATGCCTGTGACACTCTTGC
AGCTTTGTACGAATACAGT -> GCTTTGTACGAATACAGTT
CAATAGTACATTCTAAGAA -> AATAGTACATTCTAAGAAG
GCGCGAGGTCATGTCAGTA -> CGCGAGGTCATGTCAGTAC
GGTACTGACTTGACAGCTC -> GTACTGACTTGACAGCTCT
ATCTCTACAATGGGTTTAG -> TCTCTACAATGGGTTTAGG
TGAGCCCCCGCAACGCTAG -> GAGCCCCCGCAACGCTAGT
CAAACGGAGGTCAAGCTTT -> AAACGGAGGTCAAGCTTTG
TGAACTAGAACTCCGTTTC -> GAACTAGAACTCCGTTTCC
GTACGTAACCCCTGCCGTC -> TACGTAACCCCTGCCGTCG
CGCACTCCACTACAAGTCG -> GCACTCCACTACAAGTCGC
GCTAATCGTGCTACATGAA -> CTAATCGTGCTACATGAAA
ATGCCCTCTATTGTTTACT -> TGCCCTCTATTGTTTACTC
CGGTTAACGAAGGGATTAC -> GGTTAACGAAGGGATTACA
TCATCGTCTACCGAAAAAA -> CATCGTCTACCGAAAAAAA
AGGGTTTCGGTTACTGCTA -> GGGTTTCGGTTACTGCTAT
ATACTGTAGCCGGACAACG -> TACTGTAGCCGGACAACGT
CGATAAAACTGTCGTAAAA -> GATAAAACTGTCGTAAAAT
CCCCCATAAATTTTGTTAG -> CCCCATAAATTTTGTTAGG
AAAACTTGACAAGTGGTAA -> AAACTTGACAAGTGGTAAG
CTATCGGGACGAGTGTTCC -> TATCGGGACGAGTGTTCCA
TCACAACAAACGGAGGTCA -> CACAACAAACGGAGGTCAA
CGGTCTGGAGATGGGGTAA -> GGTCTGGAGATGGGGTAAC
CGGGCACATGTACGACCTA -> GGGCACATGTACGACCTAT
GGTCTAATGCGGTTAACGA -> GTCTAATGCGGTTAACGAA
CATTGTGTCATCGTCTACC -> ATTGTGTCATCGTCTACCG
TCTCCCCCATAAATTTTGT -> CTCCCCCATAAATTTTGTT
GAGCCAATAGTACATTCTA -> AGCCAATAGTACATTCTAA
CTCATTTTCTCAAATCACT -> TCATTTTCTCAAATCACTC
CTTAAGACTTTTCCTGCCA -> TTAAGACTTTTCCTGCCAG
CTACAATGGGTTTAGGTGA -> TACAATGGGTTTAGGTGAC
TCGCCCGAGATTCAGCAAT -> CGCCCGAGATTCAGCAATG
TCTTGGTTTTGGAAAACTG -> CTTGGTTTTGGAAAACTGC
CACTCCACTACAAGTCGCA -> ACTCCACTACAAGTCGCAG
GATGTCTAATCGTAACCGC -> ATGTCTAATCGTAACCGCA
ACCAGGAAAACTTGACAAG -> CCAGGAAAACTTGACAAGT
CACCCGACTCCTGATCTGA -> ACCCGACTCCTGATCTGAC
AATACTGTAGCCGGACAAC -> ATACTGTAGCCGGACAACG
TATGAACTAGAACTCCGTT -> ATGAACTAGAACTCCGTTT
TGCAGTTCGAATACAATAG -> GCAGTTCGAATACAATAGA
AGAAGTGAGCCAATAGTAC -> GAAGTGAGCCAATAGTACA
TCTCCCCCATAACTTGATA -> CTCCCCCATAACTTGATAA
CGCTGCGCGATAGTCACTG -> GCTGCGCGATAGTCACTGT
ACAGTAATGTCGATAAAAC -> CAGTAATGTCGATAAAACT
TTCTATACACTTAAATCAC -> TCTATACACTTAAATCACT
AACTGCGACGGACCGAACT -> ACTGCGACGGACCGAACTC
TGCGCGATAGTCACTGTGT -> GCGCGATAGTCACTGTGTC
ACGTAAGTCGTGTAGAGGG -> CGTAAGTCGTGTAGAGGGC
GCGTGATCCAGTCCACCAT -> CGTGATCCAGTCCACCATC
CAGTTGGTTATGGGCATCC -> AGTTGGTTATGGGCATCCA
GGCTTTTAGGCTGGGGGCG -> GCTTTTAGGCTGGGGGCGA
CTGCGTGATCCAGTCCACC -> TGCGTGATCCAGTCCACCA
CTCGGTGCTAGCTGGGGAG -> TCGGTGCTAGCTGGGGAGC
GTCAAGCTTTGTACGAATA -> TCAAGCTTTGTACGAATAC
GCGCCATACGGTTCCGATT -> CGCCATACGGTTCCGATTA
TGTTTAGGCTGGCAGCCTT -> GTTTAGGCTGGCAGCCTTC
TCCGGATCGCTTCTGGCAC -> CCGGATCGCTTCTGGCACC
CGAACGCCCTTCCTTACAA -> GAACGCCCTTCCTTACAAC
CGGCCTCTAAACCGACTAC -> GGCCTCTAAACCGACTACT
TGTCTCCCCCATAAATTTT -> GTCTCCCCCATAAATTTTG
AACTTGATAATTACAGCCC -> ACTTGATAATTACAGCCCG
TGGTTATGGGCATCCAGAT -> GGTTATGGGCATCCAGATT
TATCTACCTGTGGGAAGAA -> ATCTACCTGTGGGAAGAAT
CTCGTAGTGGCACTACAGG -> TCGTAGTGGCACTACAGGG
CCCCCATAACTTGATAATT -> CCCCATAACTTGATAATTA
AACTCCCAATAAGTCTTCC -> ACTCCCAATAAGTCTTCCC
TGCCCTCTATTGTTTACTC -> GCCCTCTATTGTTTACTCG
GAAGTAAACCCCCGAGAAG -> AAGTAAACCCCCGAGAAGT
GATGGTGCAAGGTGCTTAG -> ATGGTGCAAGGTGCTTAGT
GGTGCAAGGTGCTTAGTGA -> GTGCAAGGTGCTTAGTGAT
ACAGAGCAAGAATCCGGAT -> CAGAGCAAGAATCCGGATC
TTTCTCCGGTCTGGAGATG -> TTCTCCGGTCTGGAGATGG
TCGAGACCTATTCAGCTAA -> CGAGACCTATTCAGCTAAT
AGAACTCCGTTTCCCCGAA -> GAACTCCGTTTCCCCGAAG
TACACTTAAATCACTACAT -> ACACTTAAATCACTACATT
CGAAGGGATTACACGTCCT -> GAAGGGATTACACGTCCTT
GGTTATGGGCATCCAGATT -> GTTATGGGCATCCAGATTG
CTTGCTAGGCAGGTCAAAC -> TTGCTAGGCAGGTCAAACC
TTGTGTCATCGTCTACCGA -> TGTGTCATCGTCTACCGAA
CGAGACCTATTCAGCTAAT -> GAGACCTATTCAGCTAATC
AAACCCCCGAGAAGTTTCG -> AACCCCCGAGAAGTTTCGG
ACATGTACGACCTATAGCT -> CATGTACGACCTATAGCTG
GCAGTTCGAATACAATAGA -> CAGTTCGAATACAATAGAA
GAACTAGAACTCCGTTTCC -> AACTAGAACTCCGTTTCCC
TTTGTACGAATACAGTTGG -> TTGTACGAATACAGTTGGT
AATCGTCGGTGTAGTAAGC -> ATCGTCGGTGTAGTAAGCC
TGTTTCTCCGGTCTGGAGA -> GTTTCTCCGGTCTGGAGAT
TTGTCTCCCCCATAAGTGT -> TGTCTCCCCCATAAGTGTA
GGATACCGACGGTCTAATG -> GATACCGACGGTCTAATGC
ACCTCGAGACCTATTCAGC -> CCTCGAGACCTATTCAGCT
TAGGATTTGCTCACAACAA -> AGGATTTGCTCACAACAAA
TTGGTTTTGGAAAACTGCG -> TGGTTTTGGAAAACTGCGA
CCCCGAAGCTTGAGAACGG -> CCCGAAGCTTGAGAACGGT
GATTTAAAGGGCCAACAGG -> ATTTAAAGGGCCAACAGGA
AGTATATCTATCTGAGTGT -> GTATATCTATCTGAGTGTT
CCAATAAGTCTTCCCGTCC -> CAATAAGTCTTCCCGTCCC
AGGTGACCCGTTGTGACTT -> GGTGACCCGTTGTGACTTT
GTTACATATTCTCATTTTC -> TTACATATTCTCATTTTCT
GCGCCCCCATCTTAAGACT -> CGCCCCCATCTTAAGACTT
AGCAATGCGGTGGGTCCTA -> GCAATGCGGTGGGTCCTAC
TGCTCACAACAAACGGAGG -> GCTCACAACAAACGGAGGT
ATGGGCATCCAGATTGTCA -> TGGGCATCCAGATTGTCAA
CTAATCGTCCTATACGTAC -> TAATCGTCCTATACGTACG
AACCACACGCGACAGAGGC -> ACCACACGCGACAGAGGCC
GAAAACTTGACAAGTGGTA -> AAAACTTGACAAGTGGTAA
CGGTGGGTCCTACTGCGTG -> GGTGGGTCCTACTGCGTGA
GTAGCCGGACAACGTTCTA -> TAGCCGGACAACGTTCTAT
ATACCATTCTACAGTAATG -> TACCATTCTACAGTAATGT
TTATTGTCTCCCCCATAAG -> TATTGTCTCCCCCATAAGT
TGTCATCGTCTACCGAAAA -> GTCATCGTCTACCGAAAAA
GCTCTCTTGGTTTTGGAAA -> CTCTCTTGGTTTTGGAAAA
TTTGGAAAACTGCGACGGA -> TTGGAAAACTGCGACGGAC
TGCCGCAAGAAGTCACACA -> GCCGCAAGAAGTCACACAG
TGTCTCCCCCATAACTTGA -> GTCTCCCCCATAACTTGAT
CTTTAATTAGAACCAGGAA -> TTTAATTAGAACCAGGAAA
CAAGTCGCAGAGCCACCCG -> AAGTCGCAGAGCCACCCGA
CCCCTGCCGTCGCTGCGCG -> CCCTGCCGTCGCTGCGCGA
TTTTCATGACTGCGCTACG -> TTTCATGACTGCGCTACGG
CTAACCACACGCGACAGAG -> TAACCACACGCGACAGAGG
ATGTCAGTACCCCAACTGA -> TGTCAGTACCCCAACTGAA
CCACACGCGACAGAGGCCC -> CACACGCGACAGAGGCCCC
CATGAAATCTCTCGCGCCC -> ATGAAATCTCTCGCGCCCG
CTTATTGTCTCCCCCATAA -> TTATTGTCTCCCCCATAAC
GCGTCTAGCTTGCTTGTTT -> CGTCTAGCTTGCTTGTTTC
GAAGTTCATCCGAGTACGT -> AAGTTCATCCGAGTACGTA
ACGCCGCGGTATACAAAAG -> CGCCGCGGTATACAAAAGA
ATACACTTAAATCACTACA -> TACACTTAAATCACTACAT
GCAACACTTTGCGACGACC -> CAACACTTTGCGACGACCA
ATGGGGTAACGTCCGCGCC -> TGGGGTAACGTCCGCGCCA
TAAGTTCAAAGTAAATCCA -> AAGTTCAAAGTAAATCCAA
TACCGACGGTCTAATGCGG -> ACCGACGGTCTAATGCGGT
TATACACTTAAATCACTAC -> ATACACTTAAATCACTACA
TATTGTCTCCCCCATAATA -> ATTGTCTCCCCCATAATAA
ACTGGTTACGAGGCAACAG -> CTGGTTACGAGGCAACAGG
CTTGGTTTTGGAAAACTGC -> TTGGTTTTGGAAAACTGCG
CGTAAAATCTCTACAATGG -> GTAAAATCTCTACAATGGG
AATGCGGTTAACGAAGGGA -> ATGCGGTTAACGAAGGGAT
GCTGCCGCAATTATTGTCT -> CTGCCGCAATTATTGTCTC
AGGACCTGGATACCGACGG -> GGACCTGGATACCGACGGT
CGCCCTTCCTTACAACGTG -> GCCCTTCCTTACAACGTGC
AAGAATCCGGATCGCTTCT -> AGAATCCGGATCGCTTCTG
TAATCGTCCTATACGTACG -> AATCGTCCTATACGTACGA
GAGTACGTAACCCCTGCCG -> AGTACGTAACCCCTGCCGT
CGTGACGGCGCGAGGTCAT -> GTGACGGCGCGAGGTCATG
GTTGGTTATGGGCATCCAG -> TTGGTTATGGGCATCCAGA
TCGCTGCGCGATAGTCACT -> CGCTGCGCGATAGTCACTG
GTACTATGAACTAGAACTC -> TACTATGAACTAGAACTCC
CGTACGATGGTGCAAGGTG -> GTACGATGGTGCAAGGTGC
TATTGTCTCCCCCATAAAT -> ATTGTCTCCCCCATAAATT
AGCTGGCCGACCCACCATC -> GCTGGCCGACCCACCATCG
TAGGCAGCCCGGATGTCTA -> AGGCAGCCCGGATGTCTAA
TCCAGCCAACTGAGTGTGC -> CCAGCCAACTGAGTGTGCG
GAGTTATTGTCTCCCCCAT -> AGTTATTGTCTCCCCCATA
AGAAGGTTAACGCCGCGGT -> GAAGGTTAACGCCGCGGTA
TGGTTTTGGAAAACTGCGA -> GGTTTTGGAAAACTGCGAC
AACTAAACACAGAGCAAGA -> ACTAAACACAGAGCAAGAA
CGCTTCTGGCACCCGACTC -> GCTTCTGGCACCCGACTCC
TTATTGTCTCCCCCATAAC -> TATTGTCTCCCCCATAACT
GACAGCTCTCTTGGTTTTG -> ACAGCTCTCTTGGTTTTGG
CAACAGTGGAATGCCCTTG -> AACAGTGGAATGCCCTTGA
AAGACTTTTCCTGCCAGGA -> AGACTTTTCCTGCCAGGAC
TGCCTGTGACACTCTTGCT -> GCCTGTGACACTCTTGCTA
GGAGGTCAAGCTTTGTACG -> GAGGTCAAGCTTTGTACGA
CCACATATTTGGACATGCC -> CACATATTTGGACATGCCC
TGGCAGCCTTCGTGCTGGA -> GGCAGCCTTCGTGCTGGAT
GCTGGATAGAAACTGAGCC -> CTGGATAGAAACTGAGCCC
GGAACGGAGATGTGAGCTG -> GAACGGAGATGTGAGCTGT
GTCGCTGCGCGATAGTCAC -> TCGCTGCGCGATAGTCACT
GATTACACGTCCTTTCTAT -> ATTACACGTCCTTTCTATA
CGCCCTCGGTGCTAGCTGG -> GCCCTCGGTGCTAGCTGGG
ATTGTCTCCCCCATAACTT -> TTGTCTCCCCCATAACTTG
CCGTTGTGACTTTATTGTC -> CGTTGTGACTTTATTGTCT
AGGTCTCGGCCTCTAAACC -> GGTCTCGGCCTCTAAACCG
CCCACCATCGCTATCGGGA -> CCACCATCGCTATCGGGAC
TTTCGGCTCCTATACCATT -> TTCGGCTCCTATACCATTC
ACTTCCTTTAATTAGAACC -> CTTCCTTTAATTAGAACCA
CAACAGGACCTGATCCCAT -> AACAGGACCTGATCCCATG
CAGAGCAAGAATCCGGATC -> AGAGCAAGAATCCGGATCG
ACGGCGCGAGGTCATGTCA -> CGGCGCGAGGTCATGTCAG
CAAGGGTTTCGGTTACTGC -> AAGGGTTTCGGTTACTGCT
AGTACCCCAACTGAATAGT -> GTACCCCAACTGAATAGTA
TCTCCCCCATAAGTGTAGG -> CTCCCCCATAAGTGTAGGT
ATACAATAGAAGTGAGCCA -> TACAATAGAAGTGAGCCAA
GTAACGTGACGGCGCGAGG -> TAACGTGACGGCGCGAGGT
TTGACAAACCTCCAGCCAA -> TGACAAACCTCCAGCCAAC
CGGTTCCATGTGATTTAAA -> GGTTCCATGTGATTTAAAG
AAGGACCTGGATACCGACG -> AGGACCTGGATACCGACGG
GGGGGCGATTCAGACTCTT -> GGGGCGATTCAGACTCTTG
GAGCCACCCGAGTTCTTAA -> AGCCACCCGAGTTCTTAAT
TTCCTTTAATTAGAACCAG -> TCCTTTAATTAGAACCAGG
TGCCGCAATTATTGTCTCC -> GCCGCAATTATTGTCTCCC
AAAGATAGAGTTATTGTCT -> AAGATAGAGTTATTGTCTC
TCACTGTGTCCTTAACTGC -> CACTGTGTCCTTAACTGCC
TCAAGGAAGCATTGTGTCA -> CAAGGAAGCATTGTGTCAT
GACGTAAGTCGTGTAGAGG -> ACGTAAGTCGTGTAGAGGG
CAGAGCCACCCGAGTTCTT -> AGAGCCACCCGAGTTCTTA
ATATTCTCATTTTCTCAAA -> TATTCTCATTTTCTCAAAT
ACTACAAGTCGCAGAGCCA -> CTACAAGTCGCAGAGCCAC
ATATCTATCTGAGTGTTTA -> TATCTATCTGAGTGTTTAG
AAGTGCCGAGCTAATCGTG -> AGTGCCGAGCTAATCGTGC
ATGACAACTAAACACAGAG -> TGACAACTAAACACAGAGC
GTGACGCCCTCGGTGCTAG -> TGACGCCCTCGGTGCTAGC
CAGCCTTCGTGCTGGATAG -> AGCCTTCGTGCTGGATAGA
CCCCCGCAACGCTAGTAGT -> CCCCGCAACGCTAGTAGTG
ACTTTGCGACGACCACGAT -> CTTTGCGACGACCACGATT
CCTTCCTTACAACGTGCAG -> CTTCCTTACAACGTGCAGT
CAGAGGCCCCCCTTGCTCT -> AGAGGCCCCCCTTGCTCTT
CTAATCGTGCTACATGAAA -> TAATCGTGCTACATGAAAT
CGTGCTACATGAAATCTCT -> GTGCTACATGAAATCTCTC
CTTCTCGCACTCCACTACA -> TTCTCGCACTCCACTACAA
ACGCCCTCGGTGCTAGCTG -> CGCCCTCGGTGCTAGCTGG
CCCGCAACGCTAGTAGTGC -> CCGCAACGCTAGTAGTGCC
GGGTTTCGGTTACTGCTAT -> GGTTTCGGTTACTGCTATA
AGGAAGCATTGTGTCATCG -> GGAAGCATTGTGTCATCGT
ATTGCACACGCCACGCCCG -> TTGCACACGCCACGCCCGC
GCTTGTTTCTCCGGTCTGG -> CTTGTTTCTCCGGTCTGGA
GTCTATTGCCGGCACCTTA -> TCTATTGCCGGCACCTTAA
CTATCTACCTGTGGGAAGA -> TATCTACCTGTGGGAAGAA
CGGGACGAGTGTTCCAATC -> GGGACGAGTGTTCCAATCA
AGGGATTACACGTCCTTTC -> GGGATTACACGTCCTTTCT
CCCCCCTTGCTCTTATTGT -> CCCCCTTGCTCTTATTGTC
CCCAACTGAATAGTATATC -> CCAACTGAATAGTATATCT
CCGGATGTCTAATCGTCCT -> CGGATGTCTAATCGTCCTA
CCCATAAGTGTAGGTAATC -> CCATAAGTGTAGGTAATCA
GTAATCAGCCCGGATGTCT -> TAATCAGCCCGGATGTCTA
TCCAGTCCACCATCCAAAG -> CCAGTCCACCATCCAAAGT
TGCGGTGGGTCCTACTGCG -> GCGGTGGGTCCTACTGCGT
GAGCCTGTTTAACTGTGAC -> AGCCTGTTTAACTGTGACC
TGCATGAGGAAGGCTTTTA -> GCATGAGGAAGGCTTTTAG
GGTGGGTCCTACTGCGTGA -> GTGGGTCCTACTGCGTGAT
AATAAGTCTTCCCGTCCCA -> ATAAGTCTTCCCGTCCCAC
GACTCACCTCGAGACCTAT -> ACTCACCTCGAGACCTATT
GAGGCCCCCCTTGCTCTTA -> AGGCCCCCCTTGCTCTTAT
ATTCAGCTAATCTCCTTCT -> TTCAGCTAATCTCCTTCTA
TTCCGATTAGTATATGACT -> TCCGATTAGTATATGACTC
TGTTAGGCAGCCCGGATGT -> GTTAGGCAGCCCGGATGTC
GTATATGACAACTAAACAC -> TATATGACAACTAAACACA
TACAAGTCGCAGAGCCACC -> ACAAGTCGCAGAGCCACCC
GTCGTAAAATCTCTACAAT -> TCGTAAAATCTCTACAATG
TCAGCCCGGATGTCTAATC -> CAGCCCGGATGTCTAATCG
TACTGCTCTCGGAAGTTCA -> ACTGCTCTCGGAAGTTCAT
AATGCCGCAGCCGCCTGAA -> ATGCCGCAGCCGCCTGAAG
CACTACAAGTCGCAGAGCC -> ACTACAAGTCGCAGAGCCA
CGGATGTCTAATCGCCCGA -> GGATGTCTAATCGCCCGAG
ATTACAGCCCGGATGTCTA -> TTACAGCCCGGATGTCTAA
AGAAGTTTCGGCTCCTATA -> GAAGTTTCGGCTCCTATAC
TCCCACGCCTCGTAGTGGC -> CCCACGCCTCGTAGTGGCA
CGGTGCTAGCTGGGGAGCC -> GGTGCTAGCTGGGGAGCCT
TGAATAGTATATCTATCTG -> GAATAGTATATCTATCTGA
TTTCGCCAAACCACACGCC -> TTCGCCAAACCACACGCCA
TGATTTAAAGGGCCAACAG -> GATTTAAAGGGCCAACAGG
GTCACTGTGTCCTTAACTG -> TCACTGTGTCCTTAACTGC
GCCCCCATCTTAAGACTTT -> CCCCCATCTTAAGACTTTT
CGCCCGGGCACATGTACGA -> GCCCGGGCACATGTACGAC
CGTTTCCCCGAAGCTTGAG -> GTTTCCCCGAAGCTTGAGA
ACATACTTCCTTTAATTAG -> CATACTTCCTTTAATTAGA
GTCTCCCCCATAAATTTTG -> TCTCCCCCATAAATTTTGT
GTGCCGCAAGAAGTCACAC -> TGCCGCAAGAAGTCACACA
TGCCGCGTAACGTGACGGC -> GCCGCGTAACGTGACGGCG
GAATACAGCCCGGATGTCT -> AATACAGCCCGGATGTCTA
CACTACATTCCAAGCGGAC -> ACTACATTCCAAGCGGACT
GTATACAAAAGATAGAGTT -> TATACAAAAGATAGAGTTA
GTTTACTCGGGTCGAAATG -> TTTACTCGGGTCGAAATGC
ACCGAACTCCACATATTTG -> CCGAACTCCACATATTTGG
AGTCGTGTAGAGGGCGCCC -> GTCGTGTAGAGGGCGCCCC
GCTTTTTCATGACTGCGCT -> CTTTTTCATGACTGCGCTA
ACAACGTGCAGTTCGAATA -> CAACGTGCAGTTCGAATAC
TGTCTAATCGTCGGTGTAG -> GTCTAATCGTCGGTGTAGT
CCATCCAAAGTATATGACA -> CATCCAAAGTATATGACAA
CCCGAGTTCTTAATGCCGC -> CCGAGTTCTTAATGCCGCA
TTGCTCTTATTGTCTCCCC -> TGCTCTTATTGTCTCCCCC
TACTCGGGTCGAAATGCAT -> ACTCGGGTCGAAATGCATG
GCCCCCGCAACGCTAGTAG -> CCCCCGCAACGCTAGTAGT
TAAACCGACTGGTTACGAG -> AAACCGACTGGTTACGAGG
GAAATCTCTCGCGCCCGGG -> AAATCTCTCGCGCCCGGGC
ATAGTACATTCTAAGAAGG -> TAGTACATTCTAAGAAGGT
GTAACCGCAAGGGTTTCGG -> TAACCGCAAGGGTTTCGGT
TCGTGTAGAGGGCGCCCCC -> CGTGTAGAGGGCGCCCCCA
CCTCGGTGCTAGCTGGGGA -> CTCGGTGCTAGCTGGGGAG
TTCCAATCAAGGAAGCATT -> TCCAATCAAGGAAGCATTG
CTTTTCCTGCCAGGACATA -> TTTTCCTGCCAGGACATAC
TAATTACAGCCCGGATGTC -> AATTACAGCCCGGATGTCT
AAGTTTCGGCTCCTATACC -> AGTTTCGGCTCCTATACCA
TCCTTTAATTAGAACCAGG -> CCTTTAATTAGAACCAGGA
CCTTCTCGCACTCCACTAC -> CTTCTCGCACTCCACTACA
CATGTCTATTGCCGGCACC -> ATGTCTATTGCCGGCACCT
TACATTCTAAGAAGGTTAA -> ACATTCTAAGAAGGTTAAC
GGCACTACAGGGAACAGGG -> GCACTACAGGGAACAGGGT
ACAAACCTCCAGCCAACTG -> CAAACCTCCAGCCAACTGA
TACTGTAGCCGGACAACGT -> ACTGTAGCCGGACAACGTT
GTCGATAAAACTGTCGTAA -> TCGATAAAACTGTCGTAAA
ACCTGATCCCATGCCTGTG -> CCTGATCCCATGCCTGTGA
AGTAAGTGCCGAGCTAATC -> GTAAGTGCCGAGCTAATCG
TATTGTCTCCCCCATAACT -> ATTGTCTCCCCCATAACTT
TTGGAAAACTGCGACGGAC -> TGGAAAACTGCGACGGACC
CACACGCCACGCCCGCATG -> ACACGCCACGCCCGCATGT
AGTTCAAAGTAAATCCAAG -> GTTCAAAGTAAATCCAAGG
ATATTTGGACATGCCCTCT -> TATTTGGACATGCCCTCTA
GATGTCTAATCGTCGGTGT -> ATGTCTAATCGTCGGTGTA
TAGGTGACCCGTTGTGACT -> AGGTGACCCGTTGTGACTT
CACGCCAATACTGTAGCCG -> ACGCCAATACTGTAGCCGG
CTGAGTGTGCGCTTAAACC -> TGAGTGTGCGCTTAAACCG
CACGCGACAGAGGCCCCCC -> ACGCGACAGAGGCCCCCCT
ACAGGGAACAGGGTGCCGC -> CAGGGAACAGGGTGCCGCA
AATCAGCCCGGATGTCTAA -> ATCAGCCCGGATGTCTAAT
TGCTATAGACGTAAGTCGT -> GCTATAGACGTAAGTCGTG
ATCCAAAGTATATGACAAC -> TCCAAAGTATATGACAACT
GTGATGCGTCTAGCTTGCT -> TGATGCGTCTAGCTTGCTT
GATGTGAGCTGTGTAGGCA -> ATGTGAGCTGTGTAGGCAG
TAGTGAAGTAAACCCCCGA -> AGTGAAGTAAACCCCCGAG
TTTAGGCTGGCAGCCTTCG -> TTAGGCTGGCAGCCTTCGT
TGACTGCGCTACGGAACGC -> GACTGCGCTACGGAACGCG
TAATGCCGCAGCCGCCTGA -> AATGCCGCAGCCGCCTGAA
TTCTATCTACCTGTGGGAA -> TCTATCTACCTGTGGGAAG
GACAAGTGGTAAGTTCAAA -> ACAAGTGGTAAGTTCAAAG
TAAACCCCCGAGAAGTTTC -> AAACCCCCGAGAAGTTTCG
GGGTACTATGAACTAGAAC -> GGTACTATGAACTAGAACT
CGGTTACTGCTATAGACGT -> GGTTACTGCTATAGACGTA
TTTCCCCGAAGCTTGAGAA -> TTCCCCGAAGCTTGAGAAC
CATGTCAGTACCCCAACTG -> ATGTCAGTACCCCAACTGA
GCTTTGTACGAATACAGTT -> CTTTGTACGAATACAGTTG
CGAGCTAATCGTGCTACAT -> GAGCTAATCGTGCTACATG
TCTAATCGTCCTATACGTA -> CTAATCGTCCTATACGTAC
GCTACATGAAATCTCTCGC -> CTACATGAAATCTCTCGCG
ACGGAGGTCAAGCTTTGTA -> CGGAGGTCAAGCTTTGTAC
CTATTCAGCTAATCTCCTT -> TATTCAGCTAATCTCCTTC
TAGAGGGCGCCCCCATCTT -> AGAGGGCGCCCCCATCTTA
GCCCGGATGTCTAATCGTA -> CCCGGATGTCTAATCGTAA
GAGAAGTTTCGGCTCCTAT -> AGAAGTTTCGGCTCCTATA
CCTTTCTATACACTTAAAT -> CTTTCTATACACTTAAATC
CCTTCGTGCTGGATAGAAA -> CTTCGTGCTGGATAGAAAC
ACTCCACATATTTGGACAT -> CTCCACATATTTGGACATG
TCTCCCCCATAATAACTTG -> CTCCCCCATAATAACTTGA
GGGAAGCTGCCGCAATTAT -> GGAAGCTGCCGCAATTATT
TGGGTCCTACTGCGTGATC -> GGGTCCTACTGCGTGATCC
CGCCACGCCCGCATGTCTA -> GCCACGCCCGCATGTCTAT
TTAACTGCCGCGTAACGTG -> TAACTGCCGCGTAACGTGA
GGACTAGTTCGGGTCAAGT -> GACTAGTTCGGGTCAAGTG
GCCTGTTTAACTGTGACCG -> CCTGTTTAACTGTGACCGG
GCCGAGCTAATCGTGCTAC -> CCGAGCTAATCGTGCTACA
GCCGCAGCCGCCTGAAGGT -> CCGCAGCCGCCTGAAGGTA
GATAATTACAGCCCGGATG -> ATAATTACAGCCCGGATGT
TAGGCAGCACTAACCACAC -> AGGCAGCACTAACCACACG
GGCATCCAGATTGTCAACA -> GCATCCAGATTGTCAACAG
AATGCCCTTGACAAACCTC -> ATGCCCTTGACAAACCTCC
CCTGGATACCGACGGTCTA -> CTGGATACCGACGGTCTAA
TGGATAGAAACTGAGCCCC -> GGATAGAAACTGAGCCCCC
TGCGTCTAGCTTGCTTGTT -> GCGTCTAGCTTGCTTGTTT
GAACTCCGTTTCCCCGAAG -> AACTCCGTTTCCCCGAAGC
CGACTGGTTACGAGGCAAC -> GACTGGTTACGAGGCAACA
TAGAACTCCGTTTCCCCGA -> AGAACTCCGTTTCCCCGAA
TTCGGGTCAAGTGACTTAG -> TCGGGTCAAGTGACTTAGT
CTGTCGTAAAATCTCTACA -> TGTCGTAAAATCTCTACAA
AGCCTGTTTAACTGTGACC -> GCCTGTTTAACTGTGACCG
GTTCAAAGTAAATCCAAGG -> TTCAAAGTAAATCCAAGGT
TTTTCTCAAATCACTCCTA -> TTTCTCAAATCACTCCTAG
GGCTGGCAGCCTTCGTGCT -> GCTGGCAGCCTTCGTGCTG
CTGGTTACGAGGCAACAGG -> TGGTTACGAGGCAACAGGG
GGAAGTTCATCCGAGTACG -> GAAGTTCATCCGAGTACGT
GCGGACTAGTTCGGGTCAA -> CGGACTAGTTCGGGTCAAG
CAGTAATGTCGATAAAACT -> AGTAATGTCGATAAAACTG
CTTAAACTCCCAATAAGTC -> TTAAACTCCCAATAAGTCT
CTTGCTTGTTTCTCCGGTC -> TTGCTTGTTTCTCCGGTCT
CCGGATCGCTTCTGGCACC -> CGGATCGCTTCTGGCACCC
GAGGCAACAGGGTACTATG -> AGGCAACAGGGTACTATGA
GTGATTTAAAGGGCCAACA -> TGATTTAAAGGGCCAACAG
AGTTCATCCGAGTACGTAA -> GTTCATCCGAGTACGTAAC
CGAGATTCAGCAATGCGGT -> GAGATTCAGCAATGCGGTG
CGTGCTGGATAGAAACTGA -> GTGCTGGATAGAAACTGAG
GTAGTGCCCATTGCACACG -> TAGTGCCCATTGCACACGC
ACTGAGCCCCCGCAACGCT -> CTGAGCCCCCGCAACGCTA
TAAGTGCCGAGCTAATCGT -> AAGTGCCGAGCTAATCGTG
TAGCTTGCTTGTTTCTCCG -> AGCTTGCTTGTTTCTCCGG
TAATGTCGATAAAACTGTC -> AATGTCGATAAAACTGTCG
AAACTTGACAAGTGGTAAG -> AACTTGACAAGTGGTAAGT
AAGTTCAAAGTAAATCCAA -> AGTTCAAAGTAAATCCAAG
CTGTGTCCTTAACTGCCGC -> TGTGTCCTTAACTGCCGCG
GATTCAGACTCTTGTAGTG -> ATTCAGACTCTTGTAGTGT
AACCGACTGGTTACGAGGC -> ACCGACTGGTTACGAGGCA
GTGCAAGGTGCTTAGTGAT -> TGCAAGGTGCTTAGTGATG
CGCCAATACTGTAGCCGGA -> GCCAATACTGTAGCCGGAC
TCGGTGTAGTAAGCCTTCT -> CGGTGTAGTAAGCCTTCTC
TGTAGGCAGCACTAACCAC -> GTAGGCAGCACTAACCACA
AAGCTTTGTACGAATACAG -> AGCTTTGTACGAATACAGT
AATTAGAACCAGGAAAACT -> ATTAGAACCAGGAAAACTT
TTTCTCAAATCACTCCTAG -> TTCTCAAATCACTCCTAGG
GCTTCTGGCACCCGACTCC -> CTTCTGGCACCCGACTCCT
AGCCTTCTCGCACTCCACT -> GCCTTCTCGCACTCCACTA
AAGGCTTTTAGGCTGGGGG -> AGGCTTTTAGGCTGGGGGC
GAACGGTTCCATGTGATTT -> AACGGTTCCATGTGATTTA
AGACGTAAGTCGTGTAGAG -> GACGTAAGTCGTGTAGAGG
AGCTAATCTCCTTCTATCT -> GCTAATCTCCTTCTATCTA
AAGTCTTCCCGTCCCACGC -> AGTCTTCCCGTCCCACGCC
TGGGGAGCCTGTTTAACTG -> GGGGAGCCTGTTTAACTGT
ACTTGACAGCTCTCTTGGT -> CTTGACAGCTCTCTTGGTT
TTAGTGATGCGTCTAGCTT -> TAGTGATGCGTCTAGCTTG
GGTGCTTAGTGATGCGTCT -> GTGCTTAGTGATGCGTCTA
ACTCCACTACAAGTCGCAG -> CTCCACTACAAGTCGCAGA
ATGCATGAGGAAGGCTTTT -> TGCATGAGGAAGGCTTTTA
TAAACACAGAGCAAGAATC -> AAACACAGAGCAAGAATCC
TACGACCTATAGCTGGCCG -> ACGACCTATAGCTGGCCGA
AATAACTTGAATACAGCCC -> ATAACTTGAATACAGCCCG
GCGTAACGTGACGGCGCGA -> CGTAACGTGACGGCGCGAG
CCGAGATTCAGCAATGCGG -> CGAGATTCAGCAATGCGGT
GTTGATTTCGCCAAACCAC -> TTGATTTCGCCAAACCACA
ACAAACGGAGGTCAAGCTT -> CAAACGGAGGTCAAGCTTT
CCCATAAATTTTGTTAGGC -> CCATAAATTTTGTTAGGCA
TAAAACTGTCGTAAAATCT -> AAAACTGTCGTAAAATCTC
TTCAAAGTAAATCCAAGGT -> TCAAAGTAAATCCAAGGTC
ATAAAACTGTCGTAAAATC -> TAAAACTGTCGTAAAATCT
AACGAAGGGATTACACGTC -> ACGAAGGGATTACACGTCC
TCGCACTCCACTACAAGTC -> CGCACTCCACTACAAGTCG
ATAGACGTAAGTCGTGTAG -> TAGACGTAAGTCGTGTAGA
GAAGGTTAACGCCGCGGTA -> AAGGTTAACGCCGCGGTAT
TATATGACTCACCTCGAGA -> ATATGACTCACCTCGAGAC
GTTTCCCCGAAGCTTGAGA -> TTTCCCCGAAGCTTGAGAA
GAGGTCAAGCTTTGTACGA -> AGGTCAAGCTTTGTACGAA
TGCCCTTGACAAACCTCCA -> GCCCTTGACAAACCTCCAG
TAGTCACTGTGTCCTTAAC -> AGTCACTGTGTCCTTAACT
CCGGTCTGGAGATGGGGTA -> CGGTCTGGAGATGGGGTAA
ACTCCCAATAAGTCTTCCC -> CTCCCAATAAGTCTTCCCG
TGAGTCTTTACTGCTCTCG -> GAGTCTTTACTGCTCTCGG
TATATCTATCTGAGTGTTT -> ATATCTATCTGAGTGTTTA
CGGTCTAATGCGGTTAACG -> GGTCTAATGCGGTTAACGA
GACATACTTCCTTTAATTA -> ACATACTTCCTTTAATTAG
CTAAGAAGGTTAACGCCGC -> TAAGAAGGTTAACGCCGCG
TAGTACATTCTAAGAAGGT -> AGTACATTCTAAGAAGGTT
CATAATAACTTGAATACAG -> ATAATAACTTGAATACAGC
CAGCTCTCTTGGTTTTGGA -> AGCTCTCTTGGTTTTGGAA
ACGCCCTTCCTTACAACGT -> CGCCCTTCCTTACAACGTG
ATCCGGATCGCTTCTGGCA -> TCCGGATCGCTTCTGGCAC
AGGTTAACGCCGCGGTATA -> GGTTAACGCCGCGGTATAC
AAAGTATATGACAACTAAA -> AAGTATATGACAACTAAAC
GCTAGCTGGGGAGCCTGTT -> CTAGCTGGGGAGCCTGTTT
CAAGAATCCGGATCGCTTC -> AAGAATCCGGATCGCTTCT
AGTCACACAGTCCGCGAAC -> GTCACACAGTCCGCGAACG
CGTCCGCGCCATACGGTTC -> GTCCGCGCCATACGGTTCC
ATGTCTAATCGTCCTATAC -> TGTCTAATCGTCCTATACG
CATCGTCTACCGAAAAAAA -> ATCGTCTACCGAAAAAAAG
CGTTCTATCTGGGAAGCTG -> GTTCTATCTGGGAAGCTGC
GTCGTGTAGAGGGCGCCCC -> TCGTGTAGAGGGCGCCCCC
TAAACCGACTACTGCTTTT -> AAACCGACTACTGCTTTTT
GTCCGCGCCATACGGTTCC -> TCCGCGCCATACGGTTCCG
GACACTCTTGCTAGGCAGG -> ACACTCTTGCTAGGCAGGT
CGTGTAGAGGGCGCCCCCA -> GTGTAGAGGGCGCCCCCAT
AGTCACTGTGTCCTTAACT -> GTCACTGTGTCCTTAACTG
GCAGCACTAACCACACGCG -> CAGCACTAACCACACGCGA
AGCTGTGTAGGCAGCACTA -> GCTGTGTAGGCAGCACTAA
AACCACACGCCAATACTGT -> ACCACACGCCAATACTGTA
CTTGCTCTTATTGTCTCCC -> TTGCTCTTATTGTCTCCCC
ATCCAGATTGTCAACAGTG -> TCCAGATTGTCAACAGTGG
CATATTCTCATTTTCTCAA -> ATATTCTCATTTTCTCAAA
TCCGATTAGTATATGACTC -> CCGATTAGTATATGACTCA
GACAACTAAACACAGAGCA -> ACAACTAAACACAGAGCAA
ACCGACTGGTTACGAGGCA -> CCGACTGGTTACGAGGCAA
GTTCCAATCAAGGAAGCAT -> TTCCAATCAAGGAAGCATT
CAAACCCCCCCGCGCGGAA -> AAACCCCCCCGCGCGGAAC
GCCACCCGAGTTCTTAATG -> CCACCCGAGTTCTTAATGC
TAATCGCCCGAGATTCAGC -> AATCGCCCGAGATTCAGCA
CACATGTACGACCTATAGC -> ACATGTACGACCTATAGCT
GGCACCTTAAACTCCCAAT -> GCACCTTAAACTCCCAATA
TCCCCGAAGCTTGAGAACG -> CCCCGAAGCTTGAGAACGG
TTCGTGCTGGATAGAAACT -> TCGTGCTGGATAGAAACTG
CTCACCTCGAGACCTATTC -> TCACCTCGAGACCTATTCA
ACTACAGGGAACAGGGTGC -> CTACAGGGAACAGGGTGCC
AATCTCTCGCGCCCGGGCA -> ATCTCTCGCGCCCGGGCAC
GTAAACCCCCGAGAAGTTT -> TAAACCCCCGAGAAGTTTC
TGACGGCGCGAGGTCATGT -> GACGGCGCGAGGTCATGTC
ACATATTTGGACATGCCCT -> CATATTTGGACATGCCCTC
AAGGAAGCATTGTGTCATC -> AGGAAGCATTGTGTCATCG
TTCGCCAAACCACACGCCA -> TCGCCAAACCACACGCCAA
ACTAACCACACGCGACAGA -> CTAACCACACGCGACAGAG
ATCTGAGTGTTTAGGCTGG -> TCTGAGTGTTTAGGCTGGC
GAGTGTTCCAATCAAGGAA -> AGTGTTCCAATCAAGGAAG
CCATCGCTATCGGGACGAG -> CATCGCTATCGGGACGAGT
ATTCAGACTCTTGTAGTGT -> TTCAGACTCTTGTAGTGTT
CAACGCTAGTAGTGCCCAT -> AACGCTAGTAGTGCCCATT
ACCCACCATCGCTATCGGG -> CCCACCATCGCTATCGGGA
CGGATCGCTTCTGGCACCC -> GGATCGCTTCTGGCACCCG
CGTGCAGTTCGAATACAAT -> GTGCAGTTCGAATACAATA
CAAATCACTCCTAGGATTT -> AAATCACTCCTAGGATTTG
CAGACTCTTGTAGTGTTAC -> AGACTCTTGTAGTGTTACA
ATAAGTGTAGGTAATCAGC -> TAAGTGTAGGTAATCAGCC
TCCGGTCTGGAGATGGGGT -> CCGGTCTGGAGATGGGGTA
TGACCCGTTGTGACTTTAT -> GACCCGTTGTGACTTTATT
AGAAGTCACACAGTCCGCG -> GAAGTCACACAGTCCGCGA
AGAATCCGGATCGCTTCTG -> GAATCCGGATCGCTTCTGG
TGCTAGGCAGGTCAAACCC -> GCTAGGCAGGTCAAACCCC
CTATCTGAGTGTTTAGGCT -> TATCTGAGTGTTTAGGCTG
TGTCGATAAAACTGTCGTA -> GTCGATAAAACTGTCGTAA
ATGTCTAATCGTCGGTGTA -> TGTCTAATCGTCGGTGTAG
TCCAATCAAGGAAGCATTG -> CCAATCAAGGAAGCATTGT
CCAGCCAACTGAGTGTGCG -> CAGCCAACTGAGTGTGCGC
AACGCCCTTCCTTACAACG -> ACGCCCTTCCTTACAACGT
GGGTAACGTCCGCGCCATA -> GGTAACGTCCGCGCCATAC
TCGGCTCCTATACCATTCT -> CGGCTCCTATACCATTCTA
GCGCCCGGGCACATGTACG -> CGCCCGGGCACATGTACGA
GACAACGTTCTATCTGGGA -> ACAACGTTCTATCTGGGAA
GCACTACAGGGAACAGGGT -> CACTACAGGGAACAGGGTG
AAACTGCGACGGACCGAAC -> AACTGCGACGGACCGAACT
GGATTTGCTCACAACAAAC -> GATTTGCTCACAACAAACG
CGTCTACCGAAAAAAAGGG -> GTCTACCGAAAAAAAGGGC
CTAATCTCCTTCTATCTAC -> TAATCTCCTTCTATCTACC
CTTTACTGCTCTCGGAAGT -> TTTACTGCTCTCGGAAGTT
GACTTTATTGTCTCCCCCA -> ACTTTATTGTCTCCCCCAT
GCCAGGACATACTTCCTTT -> CCAGGACATACTTCCTTTA
CTCTCGCGCCCGGGCACAT -> TCTCGCGCCCGGGCACATG
GAAATGCATGAGGAAGGCT -> AAATGCATGAGGAAGGCTT
GGCAGCACTAACCACACGC -> GCAGCACTAACCACACGCG
CACTTTGCGACGACCACGA -> ACTTTGCGACGACCACGAT
TCTGACAAGGACCTGGATA -> CTGACAAGGACCTGGATAC
AGGTAATCAGCCCGGATGT -> GGTAATCAGCCCGGATGTC
TAGAAGTGAGCCAATAGTA -> AGAAGTGAGCCAATAGTAC
GCGCGATAGTCACTGTGTC -> CGCGATAGTCACTGTGTCC
CACAGAGCAAGAATCCGGA -> ACAGAGCAAGAATCCGGAT
GTGCTGGATAGAAACTGAG -> TGCTGGATAGAAACTGAGC
CTCCTATACCATTCTACAG -> TCCTATACCATTCTACAGT
AATCGTAACCGCAAGGGTT -> ATCGTAACCGCAAGGGTTT
AAACGGAGGTCAAGCTTTG -> AACGGAGGTCAAGCTTTGT
CATGACTGCGCTACGGAAC -> ATGACTGCGCTACGGAACG
TCGCGCCCGGGCACATGTA -> CGCGCCCGGGCACATGTAC
GCAGGTCAAACCCCCCCGC -> CAGGTCAAACCCCCCCGCG
CATGTGATTTAAAGGGCCA -> ATGTGATTTAAAGGGCCAA
TGTAGAGGGCGCCCCCATC -> GTAGAGGGCGCCCCCATCT
GAAGGTACTGACTTGACAG -> AAGGTACTGACTTGACAGC
AGTAAGCCTTCTCGCACTC -> GTAAGCCTTCTCGCACTCC
GGGTCCTACTGCGTGATCC -> GGTCCTACTGCGTGATCCA
GCTCTTATTGTCTCCCCCA -> CTCTTATTGTCTCCCCCAT
CAGCCCGGATGTCTAATCG -> AGCCCGGATGTCTAATCGT, AGCCCGGATGTCTAATCGT, AGCCCGGATGTCTAATCGC, AGCCCGGATGTCTAATCGT
GATCTGACAAGGACCTGGA -> ATCTGACAAGGACCTGGAT
CTATCTGGGAAGCTGCCGC -> TATCTGGGAAGCTGCCGCA
CTTGAGAACGGTTCCATGT -> TTGAGAACGGTTCCATGTG
TGAGTGTTTAGGCTGGCAG -> GAGTGTTTAGGCTGGCAGC
CTTGTAGTGTTACATATTC -> TTGTAGTGTTACATATTCT
TATGACAACTAAACACAGA -> ATGACAACTAAACACAGAG
CTCCCCCATAAGTGTAGGT -> TCCCCCATAAGTGTAGGTA
TTCCTTACAACGTGCAGTT -> TCCTTACAACGTGCAGTTC
CGGAACGGAGATGTGAGCT -> GGAACGGAGATGTGAGCTG
GGAACGCGGGGCATGTTCT -> GAACGCGGGGCATGTTCTA
AGAGCAAGAATCCGGATCG -> GAGCAAGAATCCGGATCGC
TGGGAAGAATGAGCCCTTG -> GGGAAGAATGAGCCCTTGA
GGGAAGAATGAGCCCTTGA -> GGAAGAATGAGCCCTTGAA
TCATGTCAGTACCCCAACT -> CATGTCAGTACCCCAACTG
AGGAAGGCTTTTAGGCTGG -> GGAAGGCTTTTAGGCTGGG
TGACAACTAAACACAGAGC -> GACAACTAAACACAGAGCA
GTGTGCGCTTAAACCGACT -> TGTGCGCTTAAACCGACTG
TCCCATGCCTGTGACACTC -> CCCATGCCTGTGACACTCT
GTAGGCAGCACTAACCACA -> TAGGCAGCACTAACCACAC
TGGGTTTAGGTGACCCGTT -> GGGTTTAGGTGACCCGTTG
GCTGGGGGCGATTCAGACT -> CTGGGGGCGATTCAGACTC
AGTCCACCATCCAAAGTAT -> GTCCACCATCCAAAGTATA
ACCTGGATACCGACGGTCT -> CCTGGATACCGACGGTCTA
GAGATGGGGTAACGTCCGC -> AGATGGGGTAACGTCCGCG
AGTGGAATGCCCTTGACAA -> GTGGAATGCCCTTGACAAA
GTTTCGGTTACTGCTATAG -> TTTCGGTTACTGCTATAGA
ATTAGAACCAGGAAAACTT -> TTAGAACCAGGAAAACTTG
TTCGAGGTGACGCCCTCGG -> TCGAGGTGACGCCCTCGGT
GCCCGGATGTCTAATCGTC -> CCCGGATGTCTAATCGTCC, CCCGGATGTCTAATCGTCG
ATTTTCTCAAATCACTCCT -> TTTTCTCAAATCACTCCTA
AATCCGGATCGCTTCTGGC -> ATCCGGATCGCTTCTGGCA
AACCTCCAGCCAACTGAGT -> ACCTCCAGCCAACTGAGTG
TGACAAACCTCCAGCCAAC -> GACAAACCTCCAGCCAACT
CACCCGAGTTCTTAATGCC -> ACCCGAGTTCTTAATGCCG
ACGTGCAGTTCGAATACAA -> CGTGCAGTTCGAATACAAT
CCCCATAATAACTTGAATA -> CCCATAATAACTTGAATAC
GATAGTCACTGTGTCCTTA -> ATAGTCACTGTGTCCTTAA
AGCCCGGATGTCTAATCGT -> GCCCGGATGTCTAATCGTC, GCCCGGATGTCTAATCGTA, GCCCGGATGTCTAATCGTC
AACAGTGGAATGCCCTTGA -> ACAGTGGAATGCCCTTGAC
GAAGTTTCGGCTCCTATAC -> AAGTTTCGGCTCCTATACC
CCTAGGATTTGCTCACAAC -> CTAGGATTTGCTCACAACA
TAAGTGTAGGTAATCAGCC -> AAGTGTAGGTAATCAGCCC
ACCTCCAGCCAACTGAGTG -> CCTCCAGCCAACTGAGTGT
TCGTCTACCGAAAAAAAGG -> CGTCTACCGAAAAAAAGGG
TGGATACCGACGGTCTAAT -> GGATACCGACGGTCTAATG
AAAGGGCAACACTTTGCGA -> AAGGGCAACACTTTGCGAC
AACGGAGGTCAAGCTTTGT -> ACGGAGGTCAAGCTTTGTA
TCTAGCTTGCTTGTTTCTC -> CTAGCTTGCTTGTTTCTCC
GCAGCCGCCTGAAGGTACT -> CAGCCGCCTGAAGGTACTG
CCGTCCCACGCCTCGTAGT -> CGTCCCACGCCTCGTAGTG
TCAAGCTTTGTACGAATAC -> CAAGCTTTGTACGAATACA
TTTTGGAAAACTGCGACGG -> TTTGGAAAACTGCGACGGA
GTGACACTCTTGCTAGGCA -> TGACACTCTTGCTAGGCAG
CGGTTGATTTCGCCAAACC -> GGTTGATTTCGCCAAACCA
CTAGCTGGGGAGCCTGTTT -> TAGCTGGGGAGCCTGTTTA
AGCCAACTGAGTGTGCGCT -> GCCAACTGAGTGTGCGCTT
ATGCGGTGGGTCCTACTGC -> TGCGGTGGGTCCTACTGCG
AGTTGGTTATGGGCATCCA -> GTTGGTTATGGGCATCCAG
ACTAGTTCGGGTCAAGTGA -> CTAGTTCGGGTCAAGTGAC
CCGAGCTAATCGTGCTACA -> CGAGCTAATCGTGCTACAT
TTTGTTAGGCAGCCCGGAT -> TTGTTAGGCAGCCCGGATG
CGATGGTGCAAGGTGCTTA -> GATGGTGCAAGGTGCTTAG
CTCTTATTGTCTCCCCCAT -> TCTTATTGTCTCCCCCATA
CCGCAAGAAGTCACACAGT -> CGCAAGAAGTCACACAGTC
CGTAACCGCAAGGGTTTCG -> GTAACCGCAAGGGTTTCGG
TCGCTATCGGGACGAGTGT -> CGCTATCGGGACGAGTGTT
CCGCGAACGCCCTTCCTTA -> CGCGAACGCCCTTCCTTAC
GGGCGCCCCCATCTTAAGA -> GGCGCCCCCATCTTAAGAC
CTTAAACCGACTGGTTACG -> TTAAACCGACTGGTTACGA
GGTTTTGGAAAACTGCGAC -> GTTTTGGAAAACTGCGACG
CCCGTTGTGACTTTATTGT -> CCGTTGTGACTTTATTGTC
CTCCCCCATAACTTGATAA -> TCCCCCATAACTTGATAAT
GGCCGACCCACCATCGCTA -> GCCGACCCACCATCGCTAT
CCCGACTCCTGATCTGACA -> CCGACTCCTGATCTGACAA
CTCTATTGTTTACTCGGGT -> TCTATTGTTTACTCGGGTC
CTATACACTTAAATCACTA -> TATACACTTAAATCACTAC
AGGGCGCCCCCATCTTAAG -> GGGCGCCCCCATCTTAAGA
TCAACAGTGGAATGCCCTT -> CAACAGTGGAATGCCCTTG
TCCTACTGCGTGATCCAGT -> CCTACTGCGTGATCCAGTC
ACCATCCAAAGTATATGAC -> CCATCCAAAGTATATGACA
GAAGGGATTACACGTCCTT -> AAGGGATTACACGTCCTTT
TTACTGCTCTCGGAAGTTC -> TACTGCTCTCGGAAGTTCA
CGGACCGAACTCCACATAT -> GGACCGAACTCCACATATT
TTTCGGTTACTGCTATAGA -> TTCGGTTACTGCTATAGAC
TTAGGTGACCCGTTGTGAC -> TAGGTGACCCGTTGTGACT
CAGGAAAACTTGACAAGTG -> AGGAAAACTTGACAAGTGG
AAGTGTAGGTAATCAGCCC -> AGTGTAGGTAATCAGCCCG
TCTCCGGTCTGGAGATGGG -> CTCCGGTCTGGAGATGGGG
TTGTAGTGTTACATATTCT -> TGTAGTGTTACATATTCTC
ACCCGTTGTGACTTTATTG -> CCCGTTGTGACTTTATTGT
GGTGACCCGTTGTGACTTT -> GTGACCCGTTGTGACTTTA
ATAGCTGGCCGACCCACCA -> TAGCTGGCCGACCCACCAT
TTGTTTACTCGGGTCGAAA -> TGTTTACTCGGGTCGAAAT
TCTATCTACCTGTGGGAAG -> CTATCTACCTGTGGGAAGA
CCCCCGCGCGGAACGGAGA -> CCCCGCGCGGAACGGAGAT
TATCGGGACGAGTGTTCCA -> ATCGGGACGAGTGTTCCAA
CTTAGTGATGCGTCTAGCT -> TTAGTGATGCGTCTAGCTT
TTCAGCTAATCTCCTTCTA -> TCAGCTAATCTCCTTCTAT
AAATTTTGTTAGGCAGCCC -> AATTTTGTTAGGCAGCCCG
CAATTATTGTCTCCCCCAT -> AATTATTGTCTCCCCCATA
CAAGGACCTGGATACCGAC -> AAGGACCTGGATACCGACG
ATCACTCCTAGGATTTGCT -> TCACTCCTAGGATTTGCTC
GGTTAACGAAGGGATTACA -> GTTAACGAAGGGATTACAC
CAGGGAACAGGGTGCCGCA -> AGGGAACAGGGTGCCGCAA
AATAGAAGTGAGCCAATAG -> ATAGAAGTGAGCCAATAGT
CTATAGCTGGCCGACCCAC -> TATAGCTGGCCGACCCACC
TCTTAATGCCGCAGCCGCC -> CTTAATGCCGCAGCCGCCT
AAATCTCTCGCGCCCGGGC -> AATCTCTCGCGCCCGGGCA
GTGTAGGCAGCACTAACCA -> TGTAGGCAGCACTAACCAC
CCGGACAACGTTCTATCTG -> CGGACAACGTTCTATCTGG
GTGCGCTTAAACCGACTGG -> TGCGCTTAAACCGACTGGT
CTGCGCGATAGTCACTGTG -> TGCGCGATAGTCACTGTGT
TCTATCTGAGTGTTTAGGC -> CTATCTGAGTGTTTAGGCT
TGTCTAATCGCCCGAGATT -> GTCTAATCGCCCGAGATTC
ATTGTCTCCCCCATAAATT -> TTGTCTCCCCCATAAATTT
GTGGCACTACAGGGAACAG -> TGGCACTACAGGGAACAGG
TTGTCTCCCCCATAATAAC -> TGTCTCCCCCATAATAACT
GTTACTGCTATAGACGTAA -> TTACTGCTATAGACGTAAG
TGATCTGACAAGGACCTGG -> GATCTGACAAGGACCTGGA
ACGCCACGCCCGCATGTCT -> CGCCACGCCCGCATGTCTA
GTGACTTAGTAAGTGCCGA -> TGACTTAGTAAGTGCCGAG
ATTTTGTTAGGCAGCCCGG -> TTTTGTTAGGCAGCCCGGA
CTGCGCTACGGAACGCGGG -> TGCGCTACGGAACGCGGGG
CCATTGCACACGCCACGCC -> CATTGCACACGCCACGCCC
GCTTAAACCGACTGGTTAC -> CTTAAACCGACTGGTTACG
TAATCGTGCTACATGAAAT -> AATCGTGCTACATGAAATC
GGACAACGTTCTATCTGGG -> GACAACGTTCTATCTGGGA
CGAGTTCTTAATGCCGCAG -> GAGTTCTTAATGCCGCAGC
CCGACTGGTTACGAGGCAA -> CGACTGGTTACGAGGCAAC
GACAAGGACCTGGATACCG -> ACAAGGACCTGGATACCGA
AACTTGACAAGTGGTAAGT -> ACTTGACAAGTGGTAAGTT
TGACTTAGTAAGTGCCGAG -> GACTTAGTAAGTGCCGAGC
TGCTTGTTTCTCCGGTCTG -> GCTTGTTTCTCCGGTCTGG
GTGGTAAGTTCAAAGTAAA -> TGGTAAGTTCAAAGTAAAT
GAATAGTATATCTATCTGA -> AATAGTATATCTATCTGAG
CTTTTAGGCTGGGGGCGAT -> TTTTAGGCTGGGGGCGATT
CAAACCACACGCCAATACT -> AAACCACACGCCAATACTG
AATCACTCCTAGGATTTGC -> ATCACTCCTAGGATTTGCT
GTCTCCCCCATAACTTGAT -> TCTCCCCCATAACTTGATA
AGTAGTGCCCATTGCACAC -> GTAGTGCCCATTGCACACG
CAACAAACGGAGGTCAAGC -> AACAAACGGAGGTCAAGCT
AGATGTGAGCTGTGTAGGC -> GATGTGAGCTGTGTAGGCA
CAAGTGGTAAGTTCAAAGT -> AAGTGGTAAGTTCAAAGTA
TAGGCTGGGGGCGATTCAG -> AGGCTGGGGGCGATTCAGA
ACCACACGCGACAGAGGCC -> CCACACGCGACAGAGGCCC
CCTTGCTCTTATTGTCTCC -> CTTGCTCTTATTGTCTCCC
TCTAGTGAAGTAAACCCCC -> CTAGTGAAGTAAACCCCCG
TTGGTTATGGGCATCCAGA -> TGGTTATGGGCATCCAGAT
CATCGCTATCGGGACGAGT -> ATCGCTATCGGGACGAGTG
GGTGTAGTAAGCCTTCTCG -> GTGTAGTAAGCCTTCTCGC
GATTAGTATATGACTCACC -> ATTAGTATATGACTCACCT
GTTTCTCCGGTCTGGAGAT -> TTTCTCCGGTCTGGAGATG
TAACGCCGCGGTATACAAA -> AACGCCGCGGTATACAAAA
CCTATACGTACGATGGTGC -> CTATACGTACGATGGTGCA
AGCTTGAGAACGGTTCCAT -> GCTTGAGAACGGTTCCATG
GTAAGCCTTCTCGCACTCC -> TAAGCCTTCTCGCACTCCA
AGCTGGGGAGCCTGTTTAA -> GCTGGGGAGCCTGTTTAAC
CGTCGGTGTAGTAAGCCTT -> GTCGGTGTAGTAAGCCTTC
CCAATAGTACATTCTAAGA -> CAATAGTACATTCTAAGAA
ATACCGACGGTCTAATGCG -> TACCGACGGTCTAATGCGG
GTCCTATACGTACGATGGT -> TCCTATACGTACGATGGTG
ATACTTCCTTTAATTAGAA -> TACTTCCTTTAATTAGAAC
TCGAGGTGACGCCCTCGGT -> CGAGGTGACGCCCTCGGTG
ACACTCTTGCTAGGCAGGT -> CACTCTTGCTAGGCAGGTC
AGTCTTCCCGTCCCACGCC -> GTCTTCCCGTCCCACGCCT
GCCAACAGGACCTGATCCC -> CCAACAGGACCTGATCCCA
CCCGAGATTCAGCAATGCG -> CCGAGATTCAGCAATGCGG
ACTCTTGTAGTGTTACATA -> CTCTTGTAGTGTTACATAT
GCGAACGCCCTTCCTTACA -> CGAACGCCCTTCCTTACAA
GGACATGCCCTCTATTGTT -> GACATGCCCTCTATTGTTT
TTGCTAGGCAGGTCAAACC -> TGCTAGGCAGGTCAAACCC
TTTAGGCTGGGGGCGATTC -> TTAGGCTGGGGGCGATTCA
GATCGCTTCTGGCACCCGA -> ATCGCTTCTGGCACCCGAC
AGAGCCACCCGAGTTCTTA -> GAGCCACCCGAGTTCTTAA
AGGTGCTTAGTGATGCGTC -> GGTGCTTAGTGATGCGTCT
CTCCCCCATAAATTTTGTT -> TCCCCCATAAATTTTGTTA
CCCTTGCTCTTATTGTCTC -> CCTTGCTCTTATTGTCTCC
CGTCGCTGCGCGATAGTCA -> GTCGCTGCGCGATAGTCAC
TGTCTCCCCCATAATAACT -> GTCTCCCCCATAATAACTT
ACACAGTCCGCGAACGCCC -> CACAGTCCGCGAACGCCCT
TTGATTTCGCCAAACCACA -> TGATTTCGCCAAACCACAC
TAGTAAGTGCCGAGCTAAT -> AGTAAGTGCCGAGCTAATC
TGTGTCATCGTCTACCGAA -> GTGTCATCGTCTACCGAAA
AAACCGACTACTGCTTTTT -> AACCGACTACTGCTTTTTC
GCTACGGAACGCGGGGCAT -> CTACGGAACGCGGGGCATG
TTGTGACTTTATTGTCTCC -> TGTGACTTTATTGTCTCCC
ACAACAAACGGAGGTCAAG -> CAACAAACGGAGGTCAAGC
GGTCTCGGCCTCTAAACCG -> GTCTCGGCCTCTAAACCGA
GCGGAACGGAGATGTGAGC -> CGGAACGGAGATGTGAGCT
TTGGACATGCCCTCTATTG -> TGGACATGCCCTCTATTGT
TAATGCGGTTAACGAAGGG -> AATGCGGTTAACGAAGGGA
GCTCCTATACCATTCTACA -> CTCCTATACCATTCTACAG
GCGAGGTCATGTCAGTACC -> CGAGGTCATGTCAGTACCC
TGACTTTATTGTCTCCCCC -> GACTTTATTGTCTCCCCCA
TGTTCTAGTGAAGTAAACC -> GTTCTAGTGAAGTAAACCC
TATTGTCTCCCCCATAAGT -> ATTGTCTCCCCCATAAGTG
CGCGCGGAACGGAGATGTG -> GCGCGGAACGGAGATGTGA
ACTGCGTGATCCAGTCCAC -> CTGCGTGATCCAGTCCACC
TGATCCCATGCCTGTGACA -> GATCCCATGCCTGTGACAC
TGTCTATTGCCGGCACCTT -> GTCTATTGCCGGCACCTTA
TATATGACAACTAAACACA -> ATATGACAACTAAACACAG
ATAGAGTTATTGTCTCCCC -> TAGAGTTATTGTCTCCCCC
GGTTTCGGTTACTGCTATA -> GTTTCGGTTACTGCTATAG
AGCCGCCTGAAGGTACTGA -> GCCGCCTGAAGGTACTGAC
GCTATAGACGTAAGTCGTG -> CTATAGACGTAAGTCGTGT
ACCGGTTGATTTCGCCAAA -> CCGGTTGATTTCGCCAAAC
CAGCTAATCTCCTTCTATC -> AGCTAATCTCCTTCTATCT
ACAAGGACCTGGATACCGA -> CAAGGACCTGGATACCGAC
AACGTTCTATCTGGGAAGC -> ACGTTCTATCTGGGAAGCT
GAGCAAGAATCCGGATCGC -> AGCAAGAATCCGGATCGCT
GTACGACCTATAGCTGGCC -> TACGACCTATAGCTGGCCG
CTTTGTACGAATACAGTTG -> TTTGTACGAATACAGTTGG
GAGATTCAGCAATGCGGTG -> AGATTCAGCAATGCGGTGG
TGCGCTTAAACCGACTGGT -> GCGCTTAAACCGACTGGTT
AGTACATTCTAAGAAGGTT -> GTACATTCTAAGAAGGTTA
TGAATACAGCCCGGATGTC -> GAATACAGCCCGGATGTCT
AGTACGTAACCCCTGCCGT -> GTACGTAACCCCTGCCGTC
CTCTTGCTAGGCAGGTCAA -> TCTTGCTAGGCAGGTCAAA
CATGAGGAAGGCTTTTAGG -> ATGAGGAAGGCTTTTAGGC
CTTCTGGCACCCGACTCCT -> TTCTGGCACCCGACTCCTG
GTCCACCATCCAAAGTATA -> TCCACCATCCAAAGTATAT
GAAGCTTGAGAACGGTTCC -> AAGCTTGAGAACGGTTCCA
TACTGCGTGATCCAGTCCA -> ACTGCGTGATCCAGTCCAC
TTAAATCACTACATTCCAA -> TAAATCACTACATTCCAAG
GTACGATGGTGCAAGGTGC -> TACGATGGTGCAAGGTGCT
TGTCTAATCGTCCTATACG -> GTCTAATCGTCCTATACGT
GGCCCCCCTTGCTCTTATT -> GCCCCCCTTGCTCTTATTG
GTCTTTACTGCTCTCGGAA -> TCTTTACTGCTCTCGGAAG
TGACGCCCTCGGTGCTAGC -> GACGCCCTCGGTGCTAGCT
GGAAGCTGCCGCAATTATT -> GAAGCTGCCGCAATTATTG
GACCTGATCCCATGCCTGT -> ACCTGATCCCATGCCTGTG
GTGTTCCAATCAAGGAAGC -> TGTTCCAATCAAGGAAGCA
TTCGAATACAATAGAAGTG -> TCGAATACAATAGAAGTGA
TAATCGTCGGTGTAGTAAG -> AATCGTCGGTGTAGTAAGC
ACAATGGGTTTAGGTGACC -> CAATGGGTTTAGGTGACCC
AAATGCATGAGGAAGGCTT -> AATGCATGAGGAAGGCTTT
GTCAACAGTGGAATGCCCT -> TCAACAGTGGAATGCCCTT
ATTCTAAGAAGGTTAACGC -> TTCTAAGAAGGTTAACGCC
CTTGATAATTACAGCCCGG -> TTGATAATTACAGCCCGGA
TACGGTTCCGATTAGTATA -> ACGGTTCCGATTAGTATAT
TAAAATCTCTACAATGGGT -> AAAATCTCTACAATGGGTT
GGATGTCTAATCGTCCTAT -> GATGTCTAATCGTCCTATA
ACCACGATTGAGTCTTTAC -> CCACGATTGAGTCTTTACT
TTAACGAAGGGATTACACG -> TAACGAAGGGATTACACGT
AACGCGGGGCATGTTCTAG -> ACGCGGGGCATGTTCTAGT
TGTGACCGGTTGATTTCGC -> GTGACCGGTTGATTTCGCC
GTCAAGTGACTTAGTAAGT -> TCAAGTGACTTAGTAAGTG
CGACCACGATTGAGTCTTT -> GACCACGATTGAGTCTTTA
CTAAACCGACTACTGCTTT -> TAAACCGACTACTGCTTTT
CTACAGTAATGTCGATAAA -> TACAGTAATGTCGATAAAA
ATCAGCCCGGATGTCTAAT -> TCAGCCCGGATGTCTAATC
AAGTCGCAGAGCCACCCGA -> AGTCGCAGAGCCACCCGAG
TAGTTCGGGTCAAGTGACT -> AGTTCGGGTCAAGTGACTT
ATACAGTTGGTTATGGGCA -> TACAGTTGGTTATGGGCAT
GCAAGGTGCTTAGTGATGC -> CAAGGTGCTTAGTGATGCG
CGGTGTAGTAAGCCTTCTC -> GGTGTAGTAAGCCTTCTCG
CCACTACAAGTCGCAGAGC -> CACTACAAGTCGCAGAGCC
GCTTAGTGATGCGTCTAGC -> CTTAGTGATGCGTCTAGCT
CGAGGCAACAGGGTACTAT -> GAGGCAACAGGGTACTATG
CAGCAATGCGGTGGGTCCT -> AGCAATGCGGTGGGTCCTA
CTAATGCGGTTAACGAAGG -> TAATGCGGTTAACGAAGGG
CCAGATTGTCAACAGTGGA -> CAGATTGTCAACAGTGGAA
GACCCGTTGTGACTTTATT -> ACCCGTTGTGACTTTATTG
GGCAACAGGGTACTATGAA -> GCAACAGGGTACTATGAAC
GGTGACGCCCTCGGTGCTA -> GTGACGCCCTCGGTGCTAG
CATAAATTTTGTTAGGCAG -> ATAAATTTTGTTAGGCAGC
TGGTTACGAGGCAACAGGG -> GGTTACGAGGCAACAGGGT
GCCTTCGTGCTGGATAGAA -> CCTTCGTGCTGGATAGAAA
TCTGAGTGTTTAGGCTGGC -> CTGAGTGTTTAGGCTGGCA
CTAATCGCCCGAGATTCAG -> TAATCGCCCGAGATTCAGC
CAGCCAACTGAGTGTGCGC -> AGCCAACTGAGTGTGCGCT
GGCATGTTCTAGTGAAGTA -> GCATGTTCTAGTGAAGTAA
CCGTCGCTGCGCGATAGTC -> CGTCGCTGCGCGATAGTCA
CGAATACAATAGAAGTGAG -> GAATACAATAGAAGTGAGC
AACCCCCGAGAAGTTTCGG -> ACCCCCGAGAAGTTTCGGC
CTTGAATACAGCCCGGATG -> TTGAATACAGCCCGGATGT
GGTCTGGAGATGGGGTAAC -> GTCTGGAGATGGGGTAACG
CCCGCATGTCTATTGCCGG -> CCGCATGTCTATTGCCGGC
CAAGGAAGCATTGTGTCAT -> AAGGAAGCATTGTGTCATC
CTTCGTGCTGGATAGAAAC -> TTCGTGCTGGATAGAAACT
TGATAATTACAGCCCGGAT -> GATAATTACAGCCCGGATG
ACCGACGGTCTAATGCGGT -> CCGACGGTCTAATGCGGTT
AGGGCAACACTTTGCGACG -> GGGCAACACTTTGCGACGA
TACATATTCTCATTTTCTC -> ACATATTCTCATTTTCTCA
GTTCGGGTCAAGTGACTTA -> TTCGGGTCAAGTGACTTAG
CACCTTAAACTCCCAATAA -> ACCTTAAACTCCCAATAAG
CTGTGACCGGTTGATTTCG -> TGTGACCGGTTGATTTCGC
GTCTAATCGTAACCGCAAG -> TCTAATCGTAACCGCAAGG
TAACTTGATAATTACAGCC -> AACTTGATAATTACAGCCC
ACTACTGCTTTTTCATGAC -> CTACTGCTTTTTCATGACT
AACGGTTCCATGTGATTTA -> ACGGTTCCATGTGATTTAA
GACCTGGATACCGACGGTC -> ACCTGGATACCGACGGTCT
CTGATCCCATGCCTGTGAC -> TGATCCCATGCCTGTGACA
AACGTCCGCGCCATACGGT -> ACGTCCGCGCCATACGGTT
CGCGCCATACGGTTCCGAT -> GCGCCATACGGTTCCGATT
CAAAAGATAGAGTTATTGT -> AAAAGATAGAGTTATTGTC
GCTTGCTTGTTTCTCCGGT -> CTTGCTTGTTTCTCCGGTC
CCGGCACCTTAAACTCCCA -> CGGCACCTTAAACTCCCAA
ATAACTTGATAATTACAGC -> TAACTTGATAATTACAGCC
CAATGCGGTGGGTCCTACT -> AATGCGGTGGGTCCTACTG
GTCAAACCCCCCCGCGCGG -> TCAAACCCCCCCGCGCGGA
AAACCACACGCCAATACTG -> AACCACACGCCAATACTGT
AACTAGAACTCCGTTTCCC -> ACTAGAACTCCGTTTCCCC
GATTGTCAACAGTGGAATG -> ATTGTCAACAGTGGAATGC
CTCAAATCACTCCTAGGAT -> TCAAATCACTCCTAGGATT
CTATGAACTAGAACTCCGT -> TATGAACTAGAACTCCGTT
CGCAAGAAGTCACACAGTC -> GCAAGAAGTCACACAGTCC
CGGGTCAAGTGACTTAGTA -> GGGTCAAGTGACTTAGTAA
AACTCCACATATTTGGACA -> ACTCCACATATTTGGACAT
AGTGGCACTACAGGGAACA -> GTGGCACTACAGGGAACAG
AAATCCAAGGTCTCGGCCT -> AATCCAAGGTCTCGGCCTC
AATGGGTTTAGGTGACCCG -> ATGGGTTTAGGTGACCCGT
CACACGCCAATACTGTAGC -> ACACGCCAATACTGTAGCC
CAGTTCGAATACAATAGAA -> AGTTCGAATACAATAGAAG
GCTTGAGAACGGTTCCATG -> CTTGAGAACGGTTCCATGT
TCGGGTCAAGTGACTTAGT -> CGGGTCAAGTGACTTAGTA
TTGCTTGTTTCTCCGGTCT -> TGCTTGTTTCTCCGGTCTG
AATACAGTTGGTTATGGGC -> ATACAGTTGGTTATGGGCA
AATCTCCTTCTATCTACCT -> ATCTCCTTCTATCTACCTG
GTGGAATGCCCTTGACAAA -> TGGAATGCCCTTGACAAAC
AAGTAAATCCAAGGTCTCG -> AGTAAATCCAAGGTCTCGG
TTAAACTCCCAATAAGTCT -> TAAACTCCCAATAAGTCTT
CACTTAAATCACTACATTC -> ACTTAAATCACTACATTCC
TTCTATCTGGGAAGCTGCC -> TCTATCTGGGAAGCTGCCG
AGTGTTCCAATCAAGGAAG -> GTGTTCCAATCAAGGAAGC
AATCGCCCGAGATTCAGCA -> ATCGCCCGAGATTCAGCAA
AGGGAACAGGGTGCCGCAA -> GGGAACAGGGTGCCGCAAG
CAATACTGTAGCCGGACAA -> AATACTGTAGCCGGACAAC
ATTGTCTCCCCCATAAGTG -> TTGTCTCCCCCATAAGTGT
CGTAGTGGCACTACAGGGA -> GTAGTGGCACTACAGGGAA
ACTTAAATCACTACATTCC -> CTTAAATCACTACATTCCA
CTGACAAGGACCTGGATAC -> TGACAAGGACCTGGATACC
CCAACAGGACCTGATCCCA -> CAACAGGACCTGATCCCAT
TGAAATCTCTCGCGCCCGG -> GAAATCTCTCGCGCCCGGG
TAATCTCCTTCTATCTACC -> AATCTCCTTCTATCTACCT
ATCCAAGGTCTCGGCCTCT -> TCCAAGGTCTCGGCCTCTA
ACCGCAAGGGTTTCGGTTA -> CCGCAAGGGTTTCGGTTAC
TGTCTAATCGTAACCGCAA -> GTCTAATCGTAACCGCAAG
AAAAAAAGGGCAACACTTT -> AAAAAAGGGCAACACTTTG
GATTTGCTCACAACAAACG -> ATTTGCTCACAACAAACGG
TAACCACACGCGACAGAGG -> AACCACACGCGACAGAGGC
ACTGTAGCCGGACAACGTT -> CTGTAGCCGGACAACGTTC
CGTAACCCCTGCCGTCGCT -> GTAACCCCTGCCGTCGCTG
TTCCATGTGATTTAAAGGG -> TCCATGTGATTTAAAGGGC
AGCTGCCGCAATTATTGTC -> GCTGCCGCAATTATTGTCT
ATCCGAGTACGTAACCCCT -> TCCGAGTACGTAACCCCTG
GTTAGGCAGCCCGGATGTC -> TTAGGCAGCCCGGATGTCT
AGATGGGGTAACGTCCGCG -> GATGGGGTAACGTCCGCGC
GCCAATACTGTAGCCGGAC -> CCAATACTGTAGCCGGACA
TCGCCAAACCACACGCCAA -> CGCCAAACCACACGCCAAT
TCCCCCATAAGTGTAGGTA -> CCCCCATAAGTGTAGGTAA
CGTCCTATACGTACGATGG -> GTCCTATACGTACGATGGT
TCCTTCTATCTACCTGTGG -> CCTTCTATCTACCTGTGGG
ACCTTAAACTCCCAATAAG -> CCTTAAACTCCCAATAAGT
CCCCGCGCGGAACGGAGAT -> CCCGCGCGGAACGGAGATG
GAAACTGAGCCCCCGCAAC -> AAACTGAGCCCCCGCAACG
TTACAACGTGCAGTTCGAA -> TACAACGTGCAGTTCGAAT
TGGGAAGCTGCCGCAATTA -> GGGAAGCTGCCGCAATTAT
CCCCCTTGCTCTTATTGTC -> CCCCTTGCTCTTATTGTCT
TCTCAAATCACTCCTAGGA -> CTCAAATCACTCCTAGGAT
TCCTGATCTGACAAGGACC -> CCTGATCTGACAAGGACCT
GACCTATTCAGCTAATCTC -> ACCTATTCAGCTAATCTCC
CCTTCTATCTACCTGTGGG -> CTTCTATCTACCTGTGGGA
CTTAAATCACTACATTCCA -> TTAAATCACTACATTCCAA
AGGTCAAGCTTTGTACGAA -> GGTCAAGCTTTGTACGAAT
CCAGGACATACTTCCTTTA -> CAGGACATACTTCCTTTAA
AATCAAGGAAGCATTGTGT -> ATCAAGGAAGCATTGTGTC
TGGTAAGTTCAAAGTAAAT -> GGTAAGTTCAAAGTAAATC
TGATGCGTCTAGCTTGCTT -> GATGCGTCTAGCTTGCTTG
CCGTTTCCCCGAAGCTTGA -> CGTTTCCCCGAAGCTTGAG
TCCCGTCCCACGCCTCGTA -> CCCGTCCCACGCCTCGTAG
TTCTAGTGAAGTAAACCCC -> TCTAGTGAAGTAAACCCCC
TGGCACTACAGGGAACAGG -> GGCACTACAGGGAACAGGG
ATCTCCTTCTATCTACCTG -> TCTCCTTCTATCTACCTGT
TTCATGACTGCGCTACGGA -> TCATGACTGCGCTACGGAA
TGCCCATTGCACACGCCAC -> GCCCATTGCACACGCCACG
GCGACAGAGGCCCCCCTTG -> CGACAGAGGCCCCCCTTGC
TTAGGCTGGCAGCCTTCGT -> TAGGCTGGCAGCCTTCGTG
TGGAAAACTGCGACGGACC -> GGAAAACTGCGACGGACCG
CTCTTGGTTTTGGAAAACT -> TCTTGGTTTTGGAAAACTG
CATGTACGACCTATAGCTG -> ATGTACGACCTATAGCTGG
GCCTGTGACACTCTTGCTA -> CCTGTGACACTCTTGCTAG
GGGAACAGGGTGCCGCAAG -> GGAACAGGGTGCCGCAAGA
AGTGCCGAGCTAATCGTGC -> GTGCCGAGCTAATCGTGCT
AGACCTATTCAGCTAATCT -> GACCTATTCAGCTAATCTC
AGCTAATCGTGCTACATGA -> GCTAATCGTGCTACATGAA
ATATGACTCACCTCGAGAC -> TATGACTCACCTCGAGACC
TCTCTTGGTTTTGGAAAAC -> CTCTTGGTTTTGGAAAACT
CCACCCGAGTTCTTAATGC -> CACCCGAGTTCTTAATGCC
TGGAATGCCCTTGACAAAC -> GGAATGCCCTTGACAAACC
GAGCCCCCGCAACGCTAGT -> AGCCCCCGCAACGCTAGTA
TCTAAGAAGGTTAACGCCG -> CTAAGAAGGTTAACGCCGC
CCGCAATTATTGTCTCCCC -> CGCAATTATTGTCTCCCCC
TGAGCCAATAGTACATTCT -> GAGCCAATAGTACATTCTA
GGACATACTTCCTTTAATT -> GACATACTTCCTTTAATTA
GGTAATCAGCCCGGATGTC -> GTAATCAGCCCGGATGTCT
TACTGCTATAGACGTAAGT -> ACTGCTATAGACGTAAGTC
TGACAAGGACCTGGATACC -> GACAAGGACCTGGATACCG
CCGAACTCCACATATTTGG -> CGAACTCCACATATTTGGA
TACGGAACGCGGGGCATGT -> ACGGAACGCGGGGCATGTT
GTCCCACGCCTCGTAGTGG -> TCCCACGCCTCGTAGTGGC
CTCGGAAGTTCATCCGAGT -> TCGGAAGTTCATCCGAGTA
TCGTCCTATACGTACGATG -> CGTCCTATACGTACGATGG
CGGAAGTTCATCCGAGTAC -> GGAAGTTCATCCGAGTACG
TTAACGCCGCGGTATACAA -> TAACGCCGCGGTATACAAA
CAAGTGACTTAGTAAGTGC -> AAGTGACTTAGTAAGTGCC
CTGGATACCGACGGTCTAA -> TGGATACCGACGGTCTAAT
TGTTACATATTCTCATTTT -> GTTACATATTCTCATTTTC
CGGCGCGAGGTCATGTCAG -> GGCGCGAGGTCATGTCAGT
CATACGGTTCCGATTAGTA -> ATACGGTTCCGATTAGTAT
TGTCAGTACCCCAACTGAA -> GTCAGTACCCCAACTGAAT
CTCCACTACAAGTCGCAGA -> TCCACTACAAGTCGCAGAG
ATGAGGAAGGCTTTTAGGC -> TGAGGAAGGCTTTTAGGCT
TGATCCAGTCCACCATCCA -> GATCCAGTCCACCATCCAA
GGTTCCATGTGATTTAAAG -> GTTCCATGTGATTTAAAGG
TCTAATCGCCCGAGATTCA -> CTAATCGCCCGAGATTCAG
CTTAATGCCGCAGCCGCCT -> TTAATGCCGCAGCCGCCTG
CCATAAGTGTAGGTAATCA -> CATAAGTGTAGGTAATCAG
CTCCTGATCTGACAAGGAC -> TCCTGATCTGACAAGGACC
AACACTTTGCGACGACCAC -> ACACTTTGCGACGACCACG
TGCGTGATCCAGTCCACCA -> GCGTGATCCAGTCCACCAT
TGACACTCTTGCTAGGCAG -> GACACTCTTGCTAGGCAGG
AGCCAATAGTACATTCTAA -> GCCAATAGTACATTCTAAG
AAGTGGTAAGTTCAAAGTA -> AGTGGTAAGTTCAAAGTAA
CCGCAGCCGCCTGAAGGTA -> CGCAGCCGCCTGAAGGTAC
GTGACGGCGCGAGGTCATG -> TGACGGCGCGAGGTCATGT
AACGTGCAGTTCGAATACA -> ACGTGCAGTTCGAATACAA
GGGAGCCTGTTTAACTGTG -> GGAGCCTGTTTAACTGTGA
TACAGTAATGTCGATAAAA -> ACAGTAATGTCGATAAAAC
TGTTTACTCGGGTCGAAAT -> GTTTACTCGGGTCGAAATG
ACCCCCGAGAAGTTTCGGC -> CCCCCGAGAAGTTTCGGCT
AGTTCGGGTCAAGTGACTT -> GTTCGGGTCAAGTGACTTA
CAAGGTCTCGGCCTCTAAA -> AAGGTCTCGGCCTCTAAAC
CCCGGATGTCTAATCGCCC -> CCGGATGTCTAATCGCCCG
CAGTACCCCAACTGAATAG -> AGTACCCCAACTGAATAGT
CAAGGTGCTTAGTGATGCG -> AAGGTGCTTAGTGATGCGT
TCGTAACCGCAAGGGTTTC -> CGTAACCGCAAGGGTTTCG
CCAGGAAAACTTGACAAGT -> CAGGAAAACTTGACAAGTG
ATTCTCATTTTCTCAAATC -> TTCTCATTTTCTCAAATCA
AGTGACTTAGTAAGTGCCG -> GTGACTTAGTAAGTGCCGA
CTCCTTCTATCTACCTGTG -> TCCTTCTATCTACCTGTGG
GCCGCAATTATTGTCTCCC -> CCGCAATTATTGTCTCCCC
GGGTCGAAATGCATGAGGA -> GGTCGAAATGCATGAGGAA
CGGGGCATGTTCTAGTGAA -> GGGGCATGTTCTAGTGAAG
CTAGTAGTGCCCATTGCAC -> TAGTAGTGCCCATTGCACA
GTCTCCCCCATAAGTGTAG -> TCTCCCCCATAAGTGTAGG
CTTGACAAGTGGTAAGTTC -> TTGACAAGTGGTAAGTTCA
TTACGAGGCAACAGGGTAC -> TACGAGGCAACAGGGTACT
TAGACGTAAGTCGTGTAGA -> AGACGTAAGTCGTGTAGAG
CCAAACCACACGCCAATAC -> CAAACCACACGCCAATACT
CATAACTTGATAATTACAG -> ATAACTTGATAATTACAGC
AGAAACTGAGCCCCCGCAA -> GAAACTGAGCCCCCGCAAC
CGGCACCTTAAACTCCCAA -> GGCACCTTAAACTCCCAAT
TTTATTGTCTCCCCCATAA -> TTATTGTCTCCCCCATAAT
GTCTAATCGCCCGAGATTC -> TCTAATCGCCCGAGATTCA
CCTTACAACGTGCAGTTCG -> CTTACAACGTGCAGTTCGA
AAGTTCATCCGAGTACGTA -> AGTTCATCCGAGTACGTAA
CTGGGGGCGATTCAGACTC -> TGGGGGCGATTCAGACTCT
GTCTAGCTTGCTTGTTTCT -> TCTAGCTTGCTTGTTTCTC
TCTGGAGATGGGGTAACGT -> CTGGAGATGGGGTAACGTC
ATTTGGACATGCCCTCTAT -> TTTGGACATGCCCTCTATT
TTGATAATTACAGCCCGGA -> TGATAATTACAGCCCGGAT
ACGCCAATACTGTAGCCGG -> CGCCAATACTGTAGCCGGA
CACATATTTGGACATGCCC -> ACATATTTGGACATGCCCT
CGAACTCCACATATTTGGA -> GAACTCCACATATTTGGAC
CAGGGTACTATGAACTAGA -> AGGGTACTATGAACTAGAA
CTGGGAAGCTGCCGCAATT -> TGGGAAGCTGCCGCAATTA
TTCTCGCACTCCACTACAA -> TCTCGCACTCCACTACAAG
TTTTTCATGACTGCGCTAC -> TTTTCATGACTGCGCTACG
TGTAGTAAGCCTTCTCGCA -> GTAGTAAGCCTTCTCGCAC
ATCCAGTCCACCATCCAAA -> TCCAGTCCACCATCCAAAG
TGTCCTTAACTGCCGCGTA -> GTCCTTAACTGCCGCGTAA
CAGCACTAACCACACGCGA -> AGCACTAACCACACGCGAC
CCAAAGTATATGACAACTA -> CAAAGTATATGACAACTAA
CCGAGTACGTAACCCCTGC -> CGAGTACGTAACCCCTGCC
AACCAGGAAAACTTGACAA -> ACCAGGAAAACTTGACAAG
ACTGTGTCCTTAACTGCCG -> CTGTGTCCTTAACTGCCGC
GACTCTTGTAGTGTTACAT -> ACTCTTGTAGTGTTACATA
GTGTTTAGGCTGGCAGCCT -> TGTTTAGGCTGGCAGCCTT
GAGTTCTTAATGCCGCAGC -> AGTTCTTAATGCCGCAGCC
CACTCTTGCTAGGCAGGTC -> ACTCTTGCTAGGCAGGTCA
TAACCCCTGCCGTCGCTGC -> AACCCCTGCCGTCGCTGCG
GTCTAATCGTCCTATACGT -> TCTAATCGTCCTATACGTA
CAAGCTTTGTACGAATACA -> AAGCTTTGTACGAATACAG
GTGCCGAGCTAATCGTGCT -> TGCCGAGCTAATCGTGCTA
GTAGAGGGCGCCCCCATCT -> TAGAGGGCGCCCCCATCTT
GCCGTCGCTGCGCGATAGT -> CCGTCGCTGCGCGATAGTC
CTCCGGTCTGGAGATGGGG -> TCCGGTCTGGAGATGGGGT
CTTAACTGCCGCGTAACGT -> TTAACTGCCGCGTAACGTG
TAACCGCAAGGGTTTCGGT -> AACCGCAAGGGTTTCGGTT
TCCGAGTACGTAACCCCTG -> CCGAGTACGTAACCCCTGC
AAGCCTTCTCGCACTCCAC -> AGCCTTCTCGCACTCCACT
AAGGGTTTCGGTTACTGCT -> AGGGTTTCGGTTACTGCTA
AGGTCAAACCCCCCCGCGC -> GGTCAAACCCCCCCGCGCG
AGATAGAGTTATTGTCTCC -> GATAGAGTTATTGTCTCCC
ACAGGGTGCCGCAAGAAGT -> CAGGGTGCCGCAAGAAGTC
AGCCTTCGTGCTGGATAGA -> GCCTTCGTGCTGGATAGAA
TCCTTAACTGCCGCGTAAC -> CCTTAACTGCCGCGTAACG
CCGACGGTCTAATGCGGTT -> CGACGGTCTAATGCGGTTA
TGGTGCAAGGTGCTTAGTG -> GGTGCAAGGTGCTTAGTGA
TGTAGGTAATCAGCCCGGA -> GTAGGTAATCAGCCCGGAT
ATCTGACAAGGACCTGGAT -> TCTGACAAGGACCTGGATA
AGGCCCCCCTTGCTCTTAT -> GGCCCCCCTTGCTCTTATT
CCATAACTTGATAATTACA -> CATAACTTGATAATTACAG
GTTCCGATTAGTATATGAC -> TTCCGATTAGTATATGACT
CCTTAACTGCCGCGTAACG -> CTTAACTGCCGCGTAACGT
AGGGCCAACAGGACCTGAT -> GGGCCAACAGGACCTGATC
CCTGATCTGACAAGGACCT -> CTGATCTGACAAGGACCTG
AAGTGAGCCAATAGTACAT -> AGTGAGCCAATAGTACATT
TATAGCTGGCCGACCCACC -> ATAGCTGGCCGACCCACCA
TACACGTCCTTTCTATACA -> ACACGTCCTTTCTATACAC
TATCTGAGTGTTTAGGCTG -> ATCTGAGTGTTTAGGCTGG
GGAATGCCCTTGACAAACC -> GAATGCCCTTGACAAACCT
TTTTAGGCTGGGGGCGATT -> TTTAGGCTGGGGGCGATTC
ACTACATTCCAAGCGGACT -> CTACATTCCAAGCGGACTA
GCAATGCGGTGGGTCCTAC -> CAATGCGGTGGGTCCTACT
GAAGTCACACAGTCCGCGA -> AAGTCACACAGTCCGCGAA
GTGGTTCGAGGTGACGCCC -> TGGTTCGAGGTGACGCCCT
TATTCAGCTAATCTCCTTC -> ATTCAGCTAATCTCCTTCT
AAACACAGAGCAAGAATCC -> AACACAGAGCAAGAATCCG
ATGTCTATTGCCGGCACCT -> TGTCTATTGCCGGCACCTT
GGGCCAACAGGACCTGATC -> GGCCAACAGGACCTGATCC
AGGTACTGACTTGACAGCT -> GGTACTGACTTGACAGCTC
CAATAAGTCTTCCCGTCCC -> AATAAGTCTTCCCGTCCCA
TTAGAACCAGGAAAACTTG -> TAGAACCAGGAAAACTTGA
ACCCGACTCCTGATCTGAC -> CCCGACTCCTGATCTGACA
TCTCTACAATGGGTTTAGG -> CTCTACAATGGGTTTAGGT
ATGACTGCGCTACGGAACG -> TGACTGCGCTACGGAACGC
ACGCCCGCATGTCTATTGC -> CGCCCGCATGTCTATTGCC
CACTAACCACACGCGACAG -> ACTAACCACACGCGACAGA
AGGCTGGGGGCGATTCAGA -> GGCTGGGGGCGATTCAGAC
TCTATTGCCGGCACCTTAA -> CTATTGCCGGCACCTTAAA
TAAGAAGGTTAACGCCGCG -> AAGAAGGTTAACGCCGCGG
CTTGACAGCTCTCTTGGTT -> TTGACAGCTCTCTTGGTTT
TTGACAAGTGGTAAGTTCA -> TGACAAGTGGTAAGTTCAA
ACAACTAAACACAGAGCAA -> CAACTAAACACAGAGCAAG
AGGGTGCCGCAAGAAGTCA -> GGGTGCCGCAAGAAGTCAC
AGACTTTTCCTGCCAGGAC -> GACTTTTCCTGCCAGGACA
CAATCAAGGAAGCATTGTG -> AATCAAGGAAGCATTGTGT
TCTACCTGTGGGAAGAATG -> CTACCTGTGGGAAGAATGA
TCCCCCATAATAACTTGAA -> CCCCCATAATAACTTGAAT
CTGGGGAGCCTGTTTAACT -> TGGGGAGCCTGTTTAACTG
TCATCCGAGTACGTAACCC -> CATCCGAGTACGTAACCCC
GTTCTTAATGCCGCAGCCG -> TTCTTAATGCCGCAGCCGC
CGAGGTGACGCCCTCGGTG -> GAGGTGACGCCCTCGGTGC
GTCATCGTCTACCGAAAAA -> TCATCGTCTACCGAAAAAA
GAAAAAAAGGGCAACACTT -> AAAAAAAGGGCAACACTTT
TTAACTGTGACCGGTTGAT -> TAACTGTGACCGGTTGATT
AAAGGGCCAACAGGACCTG -> AAGGGCCAACAGGACCTGA
AGTGAAGTAAACCCCCGAG -> GTGAAGTAAACCCCCGAGA
ACGGTTCCGATTAGTATAT -> CGGTTCCGATTAGTATATG
CCCAATAAGTCTTCCCGTC -> CCAATAAGTCTTCCCGTCC
TCCTATACGTACGATGGTG -> CCTATACGTACGATGGTGC
AATGCATGAGGAAGGCTTT -> ATGCATGAGGAAGGCTTTT
GATCCAGTCCACCATCCAA -> ATCCAGTCCACCATCCAAA
ACCTATTCAGCTAATCTCC -> CCTATTCAGCTAATCTCCT
ACTGTCGTAAAATCTCTAC -> CTGTCGTAAAATCTCTACA
ATCTACCTGTGGGAAGAAT -> TCTACCTGTGGGAAGAATG
GTGTAGGTAATCAGCCCGG -> TGTAGGTAATCAGCCCGGA
TTGAGTCTTTACTGCTCTC -> TGAGTCTTTACTGCTCTCG
ATGACTCACCTCGAGACCT -> TGACTCACCTCGAGACCTA
TCCAGATTGTCAACAGTGG -> CCAGATTGTCAACAGTGGA
CGCTATCGGGACGAGTGTT -> GCTATCGGGACGAGTGTTC
TTGTTTCTCCGGTCTGGAG -> TGTTTCTCCGGTCTGGAGA
ATCCCATGCCTGTGACACT -> TCCCATGCCTGTGACACTC
GATGTCTAATCGCCCGAGA -> ATGTCTAATCGCCCGAGAT
GTGCTTAGTGATGCGTCTA -> TGCTTAGTGATGCGTCTAG
CTTTGCGACGACCACGATT -> TTTGCGACGACCACGATTG
GCGCTACGGAACGCGGGGC -> CGCTACGGAACGCGGGGCA
GGGCACATGTACGACCTAT -> GGCACATGTACGACCTATA
ACATGCCCTCTATTGTTTA -> CATGCCCTCTATTGTTTAC
AAACTGAGCCCCCGCAACG -> AACTGAGCCCCCGCAACGC
TGACTTGACAGCTCTCTTG -> GACTTGACAGCTCTCTTGG
CGTAACGTGACGGCGCGAG -> GTAACGTGACGGCGCGAGG
TGCGCTACGGAACGCGGGG -> GCGCTACGGAACGCGGGGC
GCATTGTGTCATCGTCTAC -> CATTGTGTCATCGTCTACC
CTCCCAATAAGTCTTCCCG -> TCCCAATAAGTCTTCCCGT
CTGCGACGGACCGAACTCC -> TGCGACGGACCGAACTCCA
TGACAGCTCTCTTGGTTTT -> GACAGCTCTCTTGGTTTTG
AACAAACGGAGGTCAAGCT -> ACAAACGGAGGTCAAGCTT
ATAGTATATCTATCTGAGT -> TAGTATATCTATCTGAGTG
AAACTGTCGTAAAATCTCT -> AACTGTCGTAAAATCTCTA
TAATAACTTGAATACAGCC -> AATAACTTGAATACAGCCC
TCACCTCGAGACCTATTCA -> CACCTCGAGACCTATTCAG
TAAATCACTACATTCCAAG -> AAATCACTACATTCCAAGC
AACTTGAATACAGCCCGGA -> ACTTGAATACAGCCCGGAT
TTCTTAATGCCGCAGCCGC -> TCTTAATGCCGCAGCCGCC
TCTAATCGTCGGTGTAGTA -> CTAATCGTCGGTGTAGTAA
GGGTGCCGCAAGAAGTCAC -> GGTGCCGCAAGAAGTCACA
GTTCGAATACAATAGAAGT -> TTCGAATACAATAGAAGTG
