ATTCCGCATCT -> TTCCGCATCTA
TTCCGCATCTA -> TCCGCATCTAA
TCCGCATCTAA -> CCGCATCTAAA
CCGCATCTAAA -> CGCATCTAAAG
CGCATCTAAAG -> GCATCTAAAGG
GCATCTAAAGG -> CATCTAAAGGG
CATCTAAAGGG -> ATCTAAAGGGG
ATCTAAAGGGG -> TCTAAAGGGGC
TCTAAAGGGGC -> CTAAAGGGGCG
CTAAAGGGGCG -> TAAAGGGGCGC
TAAAGGGGCGC -> AAAGGGGCGCA
AAAGGGGCGCA -> AAGGGGCGCAA
AAGGGGCGCAA -> AGGGGCGCAAC
AGGGGCGCAAC -> GGGGCGCAACA
GGGGCGCAACA -> GGGCGCAACAA
GGGCGCAACAA -> GGCGCAACAAC
GGCGCAACAAC -> GCGCAACAACG
GCGCAACAACG -> CGCAACAACGA
CGCAACAACGA -> GCAACAACGAT
GCAACAACGAT -> CAACAACGATG
CAACAACGATG -> AACAACGATGC
AACAACGATGC -> ACAACGATGCA
ACAACGATGCA -> CAACGATGCAC
CAACGATGCAC -> AACGATGCACT
AACGATGCACT -> ACGATGCACTT
ACGATGCACTT -> CGATGCACTTG
CGATGCACTTG -> GATGCACTTGT
GATGCACTTGT -> ATGCACTTGTG
ATGCACTTGTG -> TGCACTTGTGG
TGCACTTGTGG -> GCACTTGTGGG
GCACTTGTGGG -> CACTTGTGGGT
CACTTGTGGGT -> ACTTGTGGGTC
ACTTGTGGGTC -> CTTGTGGGTCC
CTTGTGGGTCC -> TTGTGGGTCCC
TTGTGGGTCCC -> TGTGGGTCCCT
TGTGGGTCCCT -> GTGGGTCCCTA
GTGGGTCCCTA -> TGGGTCCCTAA
TGGGTCCCTAA -> GGGTCCCTAAA
GGGTCCCTAAA -> GGTCCCTAAAA
GGTCCCTAAAA -> GTCCCTAAAAC
GTCCCTAAAAC -> TCCCTAAAACG
TCCCTAAAACG -> CCCTAAAACGC
CCCTAAAACGC -> CCTAAAACGCT
CCTAAAACGCT -> CTAAAACGCTT
CTAAAACGCTT -> TAAAACGCTTA
TAAAACGCTTA -> AAAACGCTTAC
AAAACGCTTAC -> AAACGCTTACA
AAACGCTTACA -> AACGCTTACAT
AACGCTTACAT -> ACGCTTACATG
ACGCTTACATG -> CGCTTACATGA
CGCTTACATGA -> GCTTACATGAA
GCTTACATGAA -> CTTACATGAAT
CTTACATGAAT -> TTACATGAATA
TTACATGAATA -> TACATGAATAC
TACATGAATAC -> ACATGAATACG
ACATGAATACG -> CATGAATACGG
CATGAATACGG -> ATGAATACGGC
ATGAATACGGC -> TGAATACGGCC
TGAATACGGCC -> GAATACGGCCT
GAATACGGCCT -> AATACGGCCTC
AATACGGCCTC -> ATACGGCCTCT
ATACGGCCTCT -> TACGGCCTCTT
TACGGCCTCTT -> ACGGCCTCTTG
ACGGCCTCTTG -> CGGCCTCTTGG
CGGCCTCTTGG -> GGCCTCTTGGG
GGCCTCTTGGG -> GCCTCTTGGGC
GCCTCTTGGGC -> CCTCTTGGGCG
CCTCTTGGGCG -> CTCTTGGGCGG
CTCTTGGGCGG -> TCTTGGGCGGT
TCTTGGGCGGT -> CTTGGGCGGTG
CTTGGGCGGTG -> TTGGGCGGTGT
TTGGGCGGTGT -> TGGGCGGTGTC
TGGGCGGTGTC -> GGGCGGTGTCG
GGGCGGTGTCG -> GGCGGTGTCGG
GGCGGTGTCGG -> GCGGTGTCGGT
GCGGTGTCGGT -> CGGTGTCGGTG
CGGTGTCGGTG -> GGTGTCGGTGA
GGTGTCGGTGA -> GTGTCGGTGAA
GTGTCGGTGAA -> TGTCGGTGAAT
TGTCGGTGAAT -> GTCGGTGAATC
GTCGGTGAATC -> TCGGTGAATCT
TCGGTGAATCT -> CGGTGAATCTG
CGGTGAATCTG -> GGTGAATCTGG
GGTGAATCTGG -> GTGAATCTGGA
GTGAATCTGGA -> TGAATCTGGAT
TGAATCTGGAT -> GAATCTGGATG
GAATCTGGATG -> AATCTGGATGA
AATCTGGATGA -> ATCTGGATGAA
ATCTGGATGAA -> TCTGGATGAAC
TCTGGATGAAC -> CTGGATGAACA
CTGGATGAACA -> TGGATGAACAG
TGGATGAACAG -> GGATGAACAGT
GGATGAACAGT -> GATGAACAGTG
GATGAACAGTG -> ATGAACAGTGG
ATGAACAGTGG -> TGAACAGTGGC
TGAACAGTGGC -> GAACAGTGGCA
GAACAGTGGCA -> AACAGTGGCAA
AACAGTGGCAA -> ACAGTGGCAAT
ACAGTGGCAAT -> CAGTGGCAATC
CAGTGGCAATC -> AGTGGCAATCT
AGTGGCAATCT -> GTGGCAATCTC
GTGGCAATCTC -> TGGCAATCTCC
TGGCAATCTCC -> GGCAATCTCCT
GGCAATCTCCT -> GCAATCTCCTC
GCAATCTCCTC -> CAATCTCCTCA
CAATCTCCTCA -> AATCTCCTCAC
AATCTCCTCAC -> ATCTCCTCACT
ATCTCCTCACT -> TCTCCTCACTG
TCTCCTCACTG -> CTCCTCACTGT
CTCCTCACTGT -> TCCTCACTGTC
TCCTCACTGTC -> CCTCACTGTCG
CCTCACTGTCG -> CTCACTGTCGC
CTCACTGTCGC -> TCACTGTCGCT
TCACTGTCGCT -> CACTGTCGCTA
CACTGTCGCTA -> ACTGTCGCTAC
ACTGTCGCTAC -> CTGTCGCTACG
CTGTCGCTACG -> TGTCGCTACGA
TGTCGCTACGA -> GTCGCTACGAC
GTCGCTACGAC -> TCGCTACGACG
TCGCTACGACG -> CGCTACGACGG
CGCTACGACGG -> GCTACGACGGG
GCTACGACGGG -> CTACGACGGGT
CTACGACGGGT -> TACGACGGGTT
TACGACGGGTT -> ACGACGGGTTG
ACGACGGGTTG -> CGACGGGTTGT
CGACGGGTTGT -> GACGGGTTGTC
GACGGGTTGTC -> ACGGGTTGTCG
ACGGGTTGTCG -> CGGGTTGTCGG
CGGGTTGTCGG -> GGGTTGTCGGG
GGGTTGTCGGG -> GGTTGTCGGGA
GGTTGTCGGGA -> GTTGTCGGGAG
GTTGTCGGGAG -> TTGTCGGGAGG
TTGTCGGGAGG -> TGTCGGGAGGG
TGTCGGGAGGG -> GTCGGGAGGGG
GTCGGGAGGGG -> TCGGGAGGGGA
TCGGGAGGGGA -> CGGGAGGGGAT
CGGGAGGGGAT -> GGGAGGGGATG
GGGAGGGGATG -> GGAGGGGATGT
GGAGGGGATGT -> GAGGGGATGTG
GAGGGGATGTG -> AGGGGATGTGG
AGGGGATGTGG -> GGGGATGTGGG
GGGGATGTGGG -> GGGATGTGGGC
GGGATGTGGGC -> GGATGTGGGCC, GGATGTGGGCA
GGATGTGGGCC -> GATGTGGGCCC
GATGTGGGCCC -> ATGTGGGCCCC
ATGTGGGCCCC -> TGTGGGCCCCT
TGTGGGCCCCT -> GTGGGCCCCTG
GTGGGCCCCTG -> TGGGCCCCTGG
TGGGCCCCTGG -> GGGCCCCTGGC
GGGCCCCTGGC -> GGCCCCTGGCT
GGCCCCTGGCT -> GCCCCTGGCTC
GCCCCTGGCTC -> CCCCTGGCTCT
CCCCTGGCTCT -> CCCTGGCTCTC
CCCTGGCTCTC -> CCTGGCTCTCA
CCTGGCTCTCA -> CTGGCTCTCAA
CTGGCTCTCAA -> TGGCTCTCAAC
TGGCTCTCAAC -> GGCTCTCAACG
GGCTCTCAACG -> GCTCTCAACGG
GCTCTCAACGG -> CTCTCAACGGC
CTCTCAACGGC -> TCTCAACGGCC
TCTCAACGGCC -> CTCAACGGCCG
CTCAACGGCCG -> TCAACGGCCGG
TCAACGGCCGG -> CAACGGCCGGC
CAACGGCCGGC -> AACGGCCGGCC
AACGGCCGGCC -> ACGGCCGGCCT
ACGGCCGGCCT -> CGGCCGGCCTC
CGGCCGGCCTC -> GGCCGGCCTCA
GGCCGGCCTCA -> GCCGGCCTCAG
GCCGGCCTCAG -> CCGGCCTCAGT
CCGGCCTCAGT -> CGGCCTCAGTT
CGGCCTCAGTT -> GGCCTCAGTTG
GGCCTCAGTTG -> GCCTCAGTTGG
GCCTCAGTTGG -> CCTCAGTTGGT
CCTCAGTTGGT -> CTCAGTTGGTG
CTCAGTTGGTG -> TCAGTTGGTGC
TCAGTTGGTGC -> CAGTTGGTGCT
CAGTTGGTGCT -> AGTTGGTGCTC
AGTTGGTGCTC -> GTTGGTGCTCC
GTTGGTGCTCC -> TTGGTGCTCCC
TTGGTGCTCCC -> TGGTGCTCCCT
TGGTGCTCCCT -> GGTGCTCCCTA
GGTGCTCCCTA -> GTGCTCCCTAG
GTGCTCCCTAG -> TGCTCCCTAGG
TGCTCCCTAGG -> GCTCCCTAGGA
GCTCCCTAGGA -> CTCCCTAGGAT
CTCCCTAGGAT -> TCCCTAGGATA
TCCCTAGGATA -> CCCTAGGATAC
CCCTAGGATAC -> CCTAGGATACG
CCTAGGATACG -> CTAGGATACGT
CTAGGATACGT -> TAGGATACGTC
TAGGATACGTC -> AGGATACGTCT
AGGATACGTCT -> GGATACGTCTG
GGATACGTCTG -> GATACGTCTGC
GATACGTCTGC -> ATACGTCTGCC
ATACGTCTGCC -> TACGTCTGCCC
TACGTCTGCCC -> ACGTCTGCCCC
ACGTCTGCCCC -> CGTCTGCCCCG
CGTCTGCCCCG -> GTCTGCCCCGG
GTCTGCCCCGG -> TCTGCCCCGGG
TCTGCCCCGGG -> CTGCCCCGGGT
CTGCCCCGGGT -> TGCCCCGGGTT
TGCCCCGGGTT -> GCCCCGGGTTC
GCCCCGGGTTC -> CCCCGGGTTCG
CCCCGGGTTCG -> CCCGGGTTCGT
CCCGGGTTCGT -> CCGGGTTCGTC
CCGGGTTCGTC -> CGGGTTCGTCG
CGGGTTCGTCG -> GGGTTCGTCGC
GGGTTCGTCGC -> GGTTCGTCGCT
GGTTCGTCGCT -> GTTCGTCGCTG
GTTCGTCGCTG -> TTCGTCGCTGA
TTCGTCGCTGA -> TCGTCGCTGAG
TCGTCGCTGAG -> CGTCGCTGAGG
CGTCGCTGAGG -> GTCGCTGAGGA
GTCGCTGAGGA -> TCGCTGAGGAA
TCGCTGAGGAA -> CGCTGAGGAAT
CGCTGAGGAAT -> GCTGAGGAATC
GCTGAGGAATC -> CTGAGGAATCG
CTGAGGAATCG -> TGAGGAATCGC
TGAGGAATCGC -> GAGGAATCGCC
GAGGAATCGCC -> AGGAATCGCCT
AGGAATCGCCT -> GGAATCGCCTC
GGAATCGCCTC -> GAATCGCCTCC
GAATCGCCTCC -> AATCGCCTCCT
AATCGCCTCCT -> ATCGCCTCCTT
ATCGCCTCCTT -> TCGCCTCCTTT
TCGCCTCCTTT -> CGCCTCCTTTG
CGCCTCCTTTG -> GCCTCCTTTGC
GCCTCCTTTGC -> CCTCCTTTGCC
CCTCCTTTGCC -> CTCCTTTGCCC
CTCCTTTGCCC -> TCCTTTGCCCG
TCCTTTGCCCG -> CCTTTGCCCGC
CCTTTGCCCGC -> CTTTGCCCGCC
CTTTGCCCGCC -> TTTGCCCGCCG
TTTGCCCGCCG -> TTGCCCGCCGC
TTGCCCGCCGC -> TGCCCGCCGCT
TGCCCGCCGCT -> GCCCGCCGCTG
GCCCGCCGCTG -> CCCGCCGCTGC
CCCGCCGCTGC -> CCGCCGCTGCG
CCGCCGCTGCG -> CGCCGCTGCGC
CGCCGCTGCGC -> GCCGCTGCGCG
GCCGCTGCGCG -> CCGCTGCGCGC
CCGCTGCGCGC -> CGCTGCGCGCA
CGCTGCGCGCA -> GCTGCGCGCAC
GCTGCGCGCAC -> CTGCGCGCACA
CTGCGCGCACA -> TGCGCGCACAG
TGCGCGCACAG -> GCGCGCACAGG
GCGCGCACAGG -> CGCGCACAGGC
CGCGCACAGGC -> GCGCACAGGCT
GCGCACAGGCT -> CGCACAGGCTT
CGCACAGGCTT -> GCACAGGCTTA
GCACAGGCTTA -> CACAGGCTTAC
CACAGGCTTAC -> ACAGGCTTACA
ACAGGCTTACA -> CAGGCTTACAG
CAGGCTTACAG -> AGGCTTACAGC
AGGCTTACAGC -> GGCTTACAGCA
GGCTTACAGCA -> GCTTACAGCAC
GCTTACAGCAC -> CTTACAGCACA
CTTACAGCACA -> TTACAGCACAT
TTACAGCACAT -> TACAGCACATA
TACAGCACATA -> ACAGCACATAC
ACAGCACATAC -> CAGCACATACC
CAGCACATACC -> AGCACATACCA
AGCACATACCA -> GCACATACCAG
GCACATACCAG -> CACATACCAGG
CACATACCAGG -> ACATACCAGGA
ACATACCAGGA -> CATACCAGGAG
CATACCAGGAG -> ATACCAGGAGA
ATACCAGGAGA -> TACCAGGAGAA
TACCAGGAGAA -> ACCAGGAGAAT
ACCAGGAGAAT -> CCAGGAGAATA
CCAGGAGAATA -> CAGGAGAATAC
CAGGAGAATAC -> AGGAGAATACT
AGGAGAATACT -> GGAGAATACTC
GGAGAATACTC -> GAGAATACTCA
GAGAATACTCA -> AGAATACTCAT
AGAATACTCAT -> GAATACTCATA
GAATACTCATA -> AATACTCATAA
AATACTCATAA -> ATACTCATAAC
ATACTCATAAC -> TACTCATAACA
TACTCATAACA -> ACTCATAACAG
ACTCATAACAG -> CTCATAACAGG
CTCATAACAGG -> TCATAACAGGC
TCATAACAGGC -> CATAACAGGCG
CATAACAGGCG -> ATAACAGGCGC
ATAACAGGCGC -> TAACAGGCGCA
TAACAGGCGCA -> AACAGGCGCAC
AACAGGCGCAC -> ACAGGCGCACA
ACAGGCGCACA -> CAGGCGCACAC
CAGGCGCACAC -> AGGCGCACACA
AGGCGCACACA -> GGCGCACACAA
GGCGCACACAA -> GCGCACACAAA
GCGCACACAAA -> CGCACACAAAC
CGCACACAAAC -> GCACACAAACT
GCACACAAACT -> CACACAAACTT
CACACAAACTT -> ACACAAACTTC
ACACAAACTTC -> CACAAACTTCG
CACAAACTTCG -> ACAAACTTCGA
ACAAACTTCGA -> CAAACTTCGAA
CAAACTTCGAA -> AAACTTCGAAC
AAACTTCGAAC -> AACTTCGAACT
AACTTCGAACT -> ACTTCGAACTA
ACTTCGAACTA -> CTTCGAACTAG
CTTCGAACTAG -> TTCGAACTAGG
TTCGAACTAGG -> TCGAACTAGGT
TCGAACTAGGT -> CGAACTAGGTC
CGAACTAGGTC -> GAACTAGGTCG
GAACTAGGTCG -> AACTAGGTCGC
AACTAGGTCGC -> ACTAGGTCGCG
ACTAGGTCGCG -> CTAGGTCGCGA
CTAGGTCGCGA -> TAGGTCGCGAG
TAGGTCGCGAG -> AGGTCGCGAGT
AGGTCGCGAGT -> GGTCGCGAGTA
GGTCGCGAGTA -> GTCGCGAGTAG
GTCGCGAGTAG -> TCGCGAGTAGC
TCGCGAGTAGC -> CGCGAGTAGCA
CGCGAGTAGCA -> GCGAGTAGCAT
GCGAGTAGCAT -> CGAGTAGCATC
CGAGTAGCATC -> GAGTAGCATCG
GAGTAGCATCG -> AGTAGCATCGG
AGTAGCATCGG -> GTAGCATCGGC
GTAGCATCGGC -> TAGCATCGGCC
TAGCATCGGCC -> AGCATCGGCCT
AGCATCGGCCT -> GCATCGGCCTT
GCATCGGCCTT -> CATCGGCCTTA
CATCGGCCTTA -> ATCGGCCTTAG
ATCGGCCTTAG -> TCGGCCTTAGA
TCGGCCTTAGA -> CGGCCTTAGAT
CGGCCTTAGAT -> GGCCTTAGATG
GGCCTTAGATG -> GCCTTAGATGC
GCCTTAGATGC -> CCTTAGATGCA
CCTTAGATGCA -> CTTAGATGCAG
CTTAGATGCAG -> TTAGATGCAGC
TTAGATGCAGC -> TAGATGCAGCC
TAGATGCAGCC -> AGATGCAGCCT
AGATGCAGCCT -> GATGCAGCCTA
GATGCAGCCTA -> ATGCAGCCTAC
ATGCAGCCTAC -> TGCAGCCTACA
TGCAGCCTACA -> GCAGCCTACAA
GCAGCCTACAA -> CAGCCTACAAT
CAGCCTACAAT -> AGCCTACAATC
AGCCTACAATC -> GCCTACAATCA
GCCTACAATCA -> CCTACAATCAA
CCTACAATCAA -> CTACAATCAAG
CTACAATCAAG -> TACAATCAAGA
TACAATCAAGA -> ACAATCAAGAC
ACAATCAAGAC -> CAATCAAGACA
CAATCAAGACA -> AATCAAGACAG
AATCAAGACAG -> ATCAAGACAGT
ATCAAGACAGT -> TCAAGACAGTG
TCAAGACAGTG -> CAAGACAGTGG
CAAGACAGTGG -> AAGACAGTGGT
AAGACAGTGGT -> AGACAGTGGTA
AGACAGTGGTA -> GACAGTGGTAA
GACAGTGGTAA -> ACAGTGGTAAG
ACAGTGGTAAG -> CAGTGGTAAGG
CAGTGGTAAGG -> AGTGGTAAGGG
AGTGGTAAGGG -> GTGGTAAGGGT
GTGGTAAGGGT -> TGGTAAGGGTT
TGGTAAGGGTT -> GGTAAGGGTTG
GGTAAGGGTTG -> GTAAGGGTTGC
GTAAGGGTTGC -> TAAGGGTTGCT
TAAGGGTTGCT -> AAGGGTTGCTG
AAGGGTTGCTG -> AGGGTTGCTGC
AGGGTTGCTGC -> GGGTTGCTGCT
GGGTTGCTGCT -> GGTTGCTGCTT
GGTTGCTGCTT -> GTTGCTGCTTT
GTTGCTGCTTT -> TTGCTGCTTTT
TTGCTGCTTTT -> TGCTGCTTTTC
TGCTGCTTTTC -> GCTGCTTTTCC
GCTGCTTTTCC -> CTGCTTTTCCT
CTGCTTTTCCT -> TGCTTTTCCTT
TGCTTTTCCTT -> GCTTTTCCTTG
GCTTTTCCTTG -> CTTTTCCTTGT
CTTTTCCTTGT -> TTTTCCTTGTG
TTTTCCTTGTG -> TTTCCTTGTGT
TTTCCTTGTGT -> TTCCTTGTGTG
TTCCTTGTGTG -> TCCTTGTGTGA
TCCTTGTGTGA -> CCTTGTGTGAA
CCTTGTGTGAA -> CTTGTGTGAAC
CTTGTGTGAAC -> TTGTGTGAACT
TTGTGTGAACT -> TGTGTGAACTA
TGTGTGAACTA -> GTGTGAACTAG
GTGTGAACTAG -> TGTGAACTAGG
TGTGAACTAGG -> GTGAACTAGGC
GTGAACTAGGC -> TGAACTAGGCC
TGAACTAGGCC -> GAACTAGGCCA
GAACTAGGCCA -> AACTAGGCCAT
AACTAGGCCAT -> ACTAGGCCATT
ACTAGGCCATT -> CTAGGCCATTT
CTAGGCCATTT -> TAGGCCATTTC
TAGGCCATTTC -> AGGCCATTTCG
AGGCCATTTCG -> GGCCATTTCGT
GGCCATTTCGT -> GCCATTTCGTT
GCCATTTCGTT -> CCATTTCGTTG
CCATTTCGTTG -> CATTTCGTTGG
CATTTCGTTGG -> ATTTCGTTGGA
ATTTCGTTGGA -> TTTCGTTGGAG
TTTCGTTGGAG -> TTCGTTGGAGT
TTCGTTGGAGT -> TCGTTGGAGTG
TCGTTGGAGTG -> CGTTGGAGTGT
CGTTGGAGTGT -> GTTGGAGTGTT
GTTGGAGTGTT -> TTGGAGTGTTG
TTGGAGTGTTG -> TGGAGTGTTGG
TGGAGTGTTGG -> GGAGTGTTGGT
GGAGTGTTGGT -> GAGTGTTGGTT
GAGTGTTGGTT -> AGTGTTGGTTA
AGTGTTGGTTA -> GTGTTGGTTAT
GTGTTGGTTAT -> TGTTGGTTATC
TGTTGGTTATC -> GTTGGTTATCG
GTTGGTTATCG -> TTGGTTATCGA
TTGGTTATCGA -> TGGTTATCGAA
TGGTTATCGAA -> GGTTATCGAAC
GGTTATCGAAC -> GTTATCGAACA
GTTATCGAACA -> TTATCGAACAA
TTATCGAACAA -> TATCGAACAAT
TATCGAACAAT -> ATCGAACAATG
ATCGAACAATG -> TCGAACAATGA
TCGAACAATGA -> CGAACAATGAG
CGAACAATGAG -> GAACAATGAGC
GAACAATGAGC -> AACAATGAGCC
AACAATGAGCC -> ACAATGAGCCC
ACAATGAGCCC -> CAATGAGCCCA
CAATGAGCCCA -> AATGAGCCCAA
AATGAGCCCAA -> ATGAGCCCAAA
ATGAGCCCAAA -> TGAGCCCAAAC
TGAGCCCAAAC -> GAGCCCAAACA
GAGCCCAAACA -> AGCCCAAACAG
AGCCCAAACAG -> GCCCAAACAGT
GCCCAAACAGT -> CCCAAACAGTA
CCCAAACAGTA -> CCAAACAGTAT
CCAAACAGTAT -> CAAACAGTATG
CAAACAGTATG -> AAACAGTATGT
AAACAGTATGT -> AACAGTATGTG
AACAGTATGTG -> ACAGTATGTGC
ACAGTATGTGC -> CAGTATGTGCG
CAGTATGTGCG -> AGTATGTGCGG
AGTATGTGCGG -> GTATGTGCGGA
GTATGTGCGGA -> TATGTGCGGAC
TATGTGCGGAC -> ATGTGCGGACC
ATGTGCGGACC -> TGTGCGGACCT
TGTGCGGACCT -> GTGCGGACCTG
GTGCGGACCTG -> TGCGGACCTGC
TGCGGACCTGC -> GCGGACCTGCG
GCGGACCTGCG -> CGGACCTGCGG
CGGACCTGCGG -> GGACCTGCGGG
GGACCTGCGGG -> GACCTGCGGGC
GACCTGCGGGC -> ACCTGCGGGCC
ACCTGCGGGCC -> CCTGCGGGCCG
CCTGCGGGCCG -> CTGCGGGCCGT
CTGCGGGCCGT -> TGCGGGCCGTG
TGCGGGCCGTG -> GCGGGCCGTGC
GCGGGCCGTGC -> CGGGCCGTGCA
CGGGCCGTGCA -> GGGCCGTGCAT
GGGCCGTGCAT -> GGCCGTGCATT
GGCCGTGCATT -> GCCGTGCATTG
GCCGTGCATTG -> CCGTGCATTGT
CCGTGCATTGT -> CGTGCATTGTC
CGTGCATTGTC -> GTGCATTGTCT
GTGCATTGTCT -> TGCATTGTCTG
TGCATTGTCTG -> GCATTGTCTGA
GCATTGTCTGA -> CATTGTCTGAA
CATTGTCTGAA -> ATTGTCTGAAC
ATTGTCTGAAC -> TTGTCTGAACT
TTGTCTGAACT -> TGTCTGAACTC
TGTCTGAACTC -> GTCTGAACTCT
GTCTGAACTCT -> TCTGAACTCTA
TCTGAACTCTA -> CTGAACTCTAC
CTGAACTCTAC -> TGAACTCTACC
TGAACTCTACC -> GAACTCTACCT
GAACTCTACCT -> AACTCTACCTT
AACTCTACCTT -> ACTCTACCTTT
ACTCTACCTTT -> CTCTACCTTTT
CTCTACCTTTT -> TCTACCTTTTG
TCTACCTTTTG -> CTACCTTTTGA
CTACCTTTTGA -> TACCTTTTGAC
TACCTTTTGAC -> ACCTTTTGACG
ACCTTTTGACG -> CCTTTTGACGC
CCTTTTGACGC -> CTTTTGACGCG
CTTTTGACGCG -> TTTTGACGCGC
TTTTGACGCGC -> TTTGACGCGCC
TTTGACGCGCC -> TTGACGCGCCG
TTGACGCGCCG -> TGACGCGCCGG
TGACGCGCCGG -> GACGCGCCGGG
GACGCGCCGGG -> ACGCGCCGGGT
ACGCGCCGGGT -> CGCGCCGGGTA
CGCGCCGGGTA -> GCGCCGGGTAG
GCGCCGGGTAG -> CGCCGGGTAGC
CGCCGGGTAGC -> GCCGGGTAGCA
GCCGGGTAGCA -> CCGGGTAGCAC
CCGGGTAGCAC -> CGGGTAGCACC
CGGGTAGCACC -> GGGTAGCACCC
GGGTAGCACCC -> GGTAGCACCCC
GGTAGCACCCC -> GTAGCACCCCC
GTAGCACCCCC -> TAGCACCCCCC
TAGCACCCCCC -> AGCACCCCCCG
AGCACCCCCCG -> GCACCCCCCGA
GCACCCCCCGA -> CACCCCCCGAG
CACCCCCCGAG -> ACCCCCCGAGT
ACCCCCCGAGT -> CCCCCCGAGTG
CCCCCCGAGTG -> CCCCCGAGTGT
CCCCCGAGTGT -> CCCCGAGTGTG
CCCCGAGTGTG -> CCCGAGTGTGC
CCCGAGTGTGC -> CCGAGTGTGCC
CCGAGTGTGCC -> CGAGTGTGCCG
CGAGTGTGCCG -> GAGTGTGCCGT
GAGTGTGCCGT -> AGTGTGCCGTC
AGTGTGCCGTC -> GTGTGCCGTCA
GTGTGCCGTCA -> TGTGCCGTCAT
TGTGCCGTCAT -> GTGCCGTCATC
GTGCCGTCATC -> TGCCGTCATCT
TGCCGTCATCT -> GCCGTCATCTA
GCCGTCATCTA -> CCGTCATCTAA
CCGTCATCTAA -> CGTCATCTAAA
CGTCATCTAAA -> GTCATCTAAAC
GTCATCTAAAC -> TCATCTAAACT
TCATCTAAACT -> CATCTAAACTT
CATCTAAACTT -> ATCTAAACTTG
ATCTAAACTTG -> TCTAAACTTGT
TCTAAACTTGT -> CTAAACTTGTT
CTAAACTTGTT -> TAAACTTGTTT
TAAACTTGTTT -> AAACTTGTTTA
AAACTTGTTTA -> AACTTGTTTAG
AACTTGTTTAG -> ACTTGTTTAGC
ACTTGTTTAGC -> CTTGTTTAGCT
CTTGTTTAGCT -> TTGTTTAGCTA
TTGTTTAGCTA -> TGTTTAGCTAT
TGTTTAGCTAT -> GTTTAGCTATG
GTTTAGCTATG -> TTTAGCTATGG
TTTAGCTATGG -> TTAGCTATGGT
TTAGCTATGGT -> TAGCTATGGTA
TAGCTATGGTA -> AGCTATGGTAA
AGCTATGGTAA -> GCTATGGTAAG
GCTATGGTAAG -> CTATGGTAAGC
CTATGGTAAGC -> TATGGTAAGCA
TATGGTAAGCA -> ATGGTAAGCAC
ATGGTAAGCAC -> TGGTAAGCACT
TGGTAAGCACT -> GGTAAGCACTT
GGTAAGCACTT -> GTAAGCACTTT
GTAAGCACTTT -> TAAGCACTTTT
TAAGCACTTTT -> AAGCACTTTTG
AAGCACTTTTG -> AGCACTTTTGC
AGCACTTTTGC -> GCACTTTTGCC
GCACTTTTGCC -> CACTTTTGCCC
CACTTTTGCCC -> ACTTTTGCCCA
ACTTTTGCCCA -> CTTTTGCCCAC
CTTTTGCCCAC -> TTTTGCCCACC
TTTTGCCCACC -> TTTGCCCACCA
TTTGCCCACCA -> TTGCCCACCAA
TTGCCCACCAA -> TGCCCACCAAG
TGCCCACCAAG -> GCCCACCAAGT
GCCCACCAAGT -> CCCACCAAGTT
CCCACCAAGTT -> CCACCAAGTTA
CCACCAAGTTA -> CACCAAGTTAG
CACCAAGTTAG -> ACCAAGTTAGT
ACCAAGTTAGT -> CCAAGTTAGTG
CCAAGTTAGTG -> CAAGTTAGTGG
CAAGTTAGTGG -> AAGTTAGTGGG
AAGTTAGTGGG -> AGTTAGTGGGG
AGTTAGTGGGG -> GTTAGTGGGGT
GTTAGTGGGGT -> TTAGTGGGGTT
TTAGTGGGGTT -> TAGTGGGGTTA
TAGTGGGGTTA -> AGTGGGGTTAT
AGTGGGGTTAT -> GTGGGGTTATT
GTGGGGTTATT -> TGGGGTTATTC
TGGGGTTATTC -> GGGGTTATTCA
GGGGTTATTCA -> GGGTTATTCAA
GGGTTATTCAA -> GGTTATTCAAT
GGTTATTCAAT -> GTTATTCAATC
GTTATTCAATC -> TTATTCAATCT
TTATTCAATCT -> TATTCAATCTT
TATTCAATCTT -> ATTCAATCTTC
ATTCAATCTTC -> TTCAATCTTCA
TTCAATCTTCA -> TCAATCTTCAA
TCAATCTTCAA -> CAATCTTCAAG
CAATCTTCAAG -> AATCTTCAAGT
AATCTTCAAGT -> ATCTTCAAGTC
ATCTTCAAGTC -> TCTTCAAGTCT
TCTTCAAGTCT -> CTTCAAGTCTC
CTTCAAGTCTC -> TTCAAGTCTCA
TTCAAGTCTCA -> TCAAGTCTCAT
TCAAGTCTCAT -> CAAGTCTCATG
CAAGTCTCATG -> AAGTCTCATGA
AAGTCTCATGA -> AGTCTCATGAG
AGTCTCATGAG -> GTCTCATGAGC
GTCTCATGAGC -> TCTCATGAGCC
TCTCATGAGCC -> CTCATGAGCCA
CTCATGAGCCA -> TCATGAGCCAG
TCATGAGCCAG -> CATGAGCCAGT
CATGAGCCAGT -> ATGAGCCAGTT
ATGAGCCAGTT -> TGAGCCAGTTA
TGAGCCAGTTA -> GAGCCAGTTAC
GAGCCAGTTAC -> AGCCAGTTACA
AGCCAGTTACA -> GCCAGTTACAA
GCCAGTTACAA -> CCAGTTACAAG
CCAGTTACAAG -> CAGTTACAAGT
CAGTTACAAGT -> AGTTACAAGTA
AGTTACAAGTA -> GTTACAAGTAA
GTTACAAGTAA -> TTACAAGTAAG
TTACAAGTAAG -> TACAAGTAAGT
TACAAGTAAGT -> ACAAGTAAGTC
ACAAGTAAGTC -> CAAGTAAGTCC
CAAGTAAGTCC -> AAGTAAGTCCA
AAGTAAGTCCA -> AGTAAGTCCAT
AGTAAGTCCAT -> GTAAGTCCATT
GTAAGTCCATT -> TAAGTCCATTA
TAAGTCCATTA -> AAGTCCATTAC
AAGTCCATTAC -> AGTCCATTACT
AGTCCATTACT -> GTCCATTACTC
GTCCATTACTC -> TCCATTACTCG
TCCATTACTCG -> CCATTACTCGC
CCATTACTCGC -> CATTACTCGCA
CATTACTCGCA -> ATTACTCGCAA
ATTACTCGCAA -> TTACTCGCAAC
TTACTCGCAAC -> TACTCGCAACC
TACTCGCAACC -> ACTCGCAACCA
ACTCGCAACCA -> CTCGCAACCAG
CTCGCAACCAG -> TCGCAACCAGC
TCGCAACCAGC -> CGCAACCAGCG
CGCAACCAGCG -> GCAACCAGCGT
GCAACCAGCGT -> CAACCAGCGTG
CAACCAGCGTG -> AACCAGCGTGT
AACCAGCGTGT -> ACCAGCGTGTC
ACCAGCGTGTC -> CCAGCGTGTCC
CCAGCGTGTCC -> CAGCGTGTCCC
CAGCGTGTCCC -> AGCGTGTCCCA
AGCGTGTCCCA -> GCGTGTCCCAT
GCGTGTCCCAT -> CGTGTCCCATA
CGTGTCCCATA -> GTGTCCCATAT
GTGTCCCATAT -> TGTCCCATATT
TGTCCCATATT -> GTCCCATATTG
GTCCCATATTG -> TCCCATATTGA
TCCCATATTGA -> CCCATATTGAT
CCCATATTGAT -> CCATATTGATC
CCATATTGATC -> CATATTGATCT
CATATTGATCT -> ATATTGATCTA
ATATTGATCTA -> TATTGATCTAG
TATTGATCTAG -> ATTGATCTAGC
ATTGATCTAGC -> TTGATCTAGCC
TTGATCTAGCC -> TGATCTAGCCT
TGATCTAGCCT -> GATCTAGCCTA
GATCTAGCCTA -> ATCTAGCCTAA
ATCTAGCCTAA -> TCTAGCCTAAT
TCTAGCCTAAT -> CTAGCCTAATG
CTAGCCTAATG -> TAGCCTAATGG
TAGCCTAATGG -> AGCCTAATGGC
AGCCTAATGGC -> GCCTAATGGCT
GCCTAATGGCT -> CCTAATGGCTA
CCTAATGGCTA -> CTAATGGCTAC
CTAATGGCTAC -> TAATGGCTACT
TAATGGCTACT -> AATGGCTACTT
AATGGCTACTT -> ATGGCTACTTG
ATGGCTACTTG -> TGGCTACTTGG
TGGCTACTTGG -> GGCTACTTGGG
GGCTACTTGGG -> GCTACTTGGGT
GCTACTTGGGT -> CTACTTGGGTC
CTACTTGGGTC -> TACTTGGGTCT
TACTTGGGTCT -> ACTTGGGTCTC
ACTTGGGTCTC -> CTTGGGTCTCG
CTTGGGTCTCG -> TTGGGTCTCGG
TTGGGTCTCGG -> TGGGTCTCGGT
TGGGTCTCGGT -> GGGTCTCGGTG
GGGTCTCGGTG -> GGTCTCGGTGT
GGTCTCGGTGT -> GTCTCGGTGTC
GTCTCGGTGTC -> TCTCGGTGTCG
TCTCGGTGTCG -> CTCGGTGTCGG
CTCGGTGTCGG -> TCGGTGTCGGG
TCGGTGTCGGG -> CGGTGTCGGGC
CGGTGTCGGGC -> GGTGTCGGGCG
GGTGTCGGGCG -> GTGTCGGGCGA
GTGTCGGGCGA -> TGTCGGGCGAC
TGTCGGGCGAC -> GTCGGGCGACC
GTCGGGCGACC -> TCGGGCGACCG
TCGGGCGACCG -> CGGGCGACCGT
CGGGCGACCGT -> GGGCGACCGTT
GGGCGACCGTT -> GGCGACCGTTT
GGCGACCGTTT -> GCGACCGTTTT
GCGACCGTTTT -> CGACCGTTTTG
CGACCGTTTTG -> GACCGTTTTGC
GACCGTTTTGC -> ACCGTTTTGCC
ACCGTTTTGCC -> CCGTTTTGCCG
CCGTTTTGCCG -> CGTTTTGCCGG
CGTTTTGCCGG -> GTTTTGCCGGG
GTTTTGCCGGG -> TTTTGCCGGGA
TTTTGCCGGGA -> TTTGCCGGGAT
TTTGCCGGGAT -> TTGCCGGGATG
TTGCCGGGATG -> TGCCGGGATGA
TGCCGGGATGA -> GCCGGGATGAC
GCCGGGATGAC -> CCGGGATGACC
CCGGGATGACC -> CGGGATGACCG
CGGGATGACCG -> GGGATGACCGT
GGGATGACCGT -> GGATGACCGTC
GGATGACCGTC -> GATGACCGTCG
GATGACCGTCG -> ATGACCGTCGG
ATGACCGTCGG -> TGACCGTCGGA
TGACCGTCGGA -> GACCGTCGGAG
GACCGTCGGAG -> ACCGTCGGAGT
ACCGTCGGAGT -> CCGTCGGAGTC
CCGTCGGAGTC -> CGTCGGAGTCA
CGTCGGAGTCA -> GTCGGAGTCAT
GTCGGAGTCAT -> TCGGAGTCATG
TCGGAGTCATG -> CGGAGTCATGC
CGGAGTCATGC -> GGAGTCATGCG
GGAGTCATGCG -> GAGTCATGCGG
GAGTCATGCGG -> AGTCATGCGGG
AGTCATGCGGG -> GTCATGCGGGG
GTCATGCGGGG -> TCATGCGGGGT
TCATGCGGGGT -> CATGCGGGGTA
CATGCGGGGTA -> ATGCGGGGTAT
ATGCGGGGTAT -> TGCGGGGTATA
TGCGGGGTATA -> GCGGGGTATAC
GCGGGGTATAC -> CGGGGTATACT
CGGGGTATACT -> GGGGTATACTG
GGGGTATACTG -> GGGTATACTGC
GGGTATACTGC -> GGTATACTGCT
GGTATACTGCT -> GTATACTGCTA
GTATACTGCTA -> TATACTGCTAG
TATACTGCTAG -> ATACTGCTAGT
ATACTGCTAGT -> TACTGCTAGTT
TACTGCTAGTT -> ACTGCTAGTTA
ACTGCTAGTTA -> CTGCTAGTTAC
CTGCTAGTTAC -> TGCTAGTTACT
TGCTAGTTACT -> GCTAGTTACTC
GCTAGTTACTC -> CTAGTTACTCA
CTAGTTACTCA -> TAGTTACTCAC
TAGTTACTCAC -> AGTTACTCACT
AGTTACTCACT -> GTTACTCACTT
GTTACTCACTT -> TTACTCACTTA
TTACTCACTTA -> TACTCACTTAA
TACTCACTTAA -> ACTCACTTAAT
ACTCACTTAAT -> CTCACTTAATG
CTCACTTAATG -> TCACTTAATGG
TCACTTAATGG -> CACTTAATGGC
CACTTAATGGC -> ACTTAATGGCG
ACTTAATGGCG -> CTTAATGGCGG
CTTAATGGCGG -> TTAATGGCGGT
TTAATGGCGGT -> TAATGGCGGTA
TAATGGCGGTA -> AATGGCGGTAG
AATGGCGGTAG -> ATGGCGGTAGG
ATGGCGGTAGG -> TGGCGGTAGGA
TGGCGGTAGGA -> GGCGGTAGGAA
GGCGGTAGGAA -> GCGGTAGGAAC
GCGGTAGGAAC -> CGGTAGGAACC
CGGTAGGAACC -> GGTAGGAACCC
GGTAGGAACCC -> GTAGGAACCCT
GTAGGAACCCT -> TAGGAACCCTG
TAGGAACCCTG -> AGGAACCCTGC
AGGAACCCTGC -> GGAACCCTGCT
GGAACCCTGCT -> GAACCCTGCTG
GAACCCTGCTG -> AACCCTGCTGC
AACCCTGCTGC -> ACCCTGCTGCA
ACCCTGCTGCA -> CCCTGCTGCAT
CCCTGCTGCAT -> CCTGCTGCATG
CCTGCTGCATG -> CTGCTGCATGA
CTGCTGCATGA -> TGCTGCATGAT
TGCTGCATGAT -> GCTGCATGATG
GCTGCATGATG -> CTGCATGATGA
CTGCATGATGA -> TGCATGATGAA
TGCATGATGAA -> GCATGATGAAC
GCATGATGAAC -> CATGATGAACG
CATGATGAACG -> ATGATGAACGA
ATGATGAACGA -> TGATGAACGAT
TGATGAACGAT -> GATGAACGATT
GATGAACGATT -> ATGAACGATTC
ATGAACGATTC -> TGAACGATTCC
TGAACGATTCC -> GAACGATTCCA
GAACGATTCCA -> AACGATTCCAC
AACGATTCCAC -> ACGATTCCACG
ACGATTCCACG -> CGATTCCACGT
CGATTCCACGT -> GATTCCACGTA
GATTCCACGTA -> ATTCCACGTAT
ATTCCACGTAT -> TTCCACGTATT
TTCCACGTATT -> TCCACGTATTC
TCCACGTATTC -> CCACGTATTCC
CCACGTATTCC -> CACGTATTCCC
CACGTATTCCC -> ACGTATTCCCA
ACGTATTCCCA -> CGTATTCCCAA
CGTATTCCCAA -> GTATTCCCAAA
GTATTCCCAAA -> TATTCCCAAAG
TATTCCCAAAG -> ATTCCCAAAGG
ATTCCCAAAGG -> TTCCCAAAGGC
TTCCCAAAGGC -> TCCCAAAGGCA
TCCCAAAGGCA -> CCCAAAGGCAC
CCCAAAGGCAC -> CCAAAGGCACC
CCAAAGGCACC -> CAAAGGCACCC
CAAAGGCACCC -> AAAGGCACCCA
AAAGGCACCCA -> AAGGCACCCAC
AAGGCACCCAC -> AGGCACCCACG
AGGCACCCACG -> GGCACCCACGG
GGCACCCACGG -> GCACCCACGGT
GCACCCACGGT -> CACCCACGGTC
CACCCACGGTC -> ACCCACGGTCT
ACCCACGGTCT -> CCCACGGTCTC
CCCACGGTCTC -> CCACGGTCTCG
CCACGGTCTCG -> CACGGTCTCGA
CACGGTCTCGA -> ACGGTCTCGAG
ACGGTCTCGAG -> CGGTCTCGAGT
CGGTCTCGAGT -> GGTCTCGAGTG
GGTCTCGAGTG -> GTCTCGAGTGA
GTCTCGAGTGA -> TCTCGAGTGAA
TCTCGAGTGAA -> CTCGAGTGAAT
CTCGAGTGAAT -> TCGAGTGAATG
TCGAGTGAATG -> CGAGTGAATGC
CGAGTGAATGC -> GAGTGAATGCT
GAGTGAATGCT -> AGTGAATGCTT
AGTGAATGCTT -> GTGAATGCTTA
GTGAATGCTTA -> TGAATGCTTAA
TGAATGCTTAA -> GAATGCTTAAA
GAATGCTTAAA -> AATGCTTAAAA
AATGCTTAAAA -> ATGCTTAAAAT
ATGCTTAAAAT -> TGCTTAAAATA
TGCTTAAAATA -> GCTTAAAATAA
GCTTAAAATAA -> CTTAAAATAAC
CTTAAAATAAC -> TTAAAATAACG
TTAAAATAACG -> TAAAATAACGG
TAAAATAACGG -> AAAATAACGGA
AAAATAACGGA -> AAATAACGGAA
AAATAACGGAA -> AATAACGGAAT
AATAACGGAAT -> ATAACGGAATT
ATAACGGAATT -> TAACGGAATTC
TAACGGAATTC -> AACGGAATTCC
AACGGAATTCC -> ACGGAATTCCA
ACGGAATTCCA -> CGGAATTCCAA
CGGAATTCCAA -> GGAATTCCAAT
GGAATTCCAAT -> GAATTCCAATA
GAATTCCAATA -> AATTCCAATAT
AATTCCAATAT -> ATTCCAATATG
ATTCCAATATG -> TTCCAATATGT
TTCCAATATGT -> TCCAATATGTA
TCCAATATGTA -> CCAATATGTAG
CCAATATGTAG -> CAATATGTAGT
CAATATGTAGT -> AATATGTAGTG
AATATGTAGTG -> ATATGTAGTGT
ATATGTAGTGT -> TATGTAGTGTG
TATGTAGTGTG -> ATGTAGTGTGG
ATGTAGTGTGG -> TGTAGTGTGGA
TGTAGTGTGGA -> GTAGTGTGGAG
GTAGTGTGGAG -> TAGTGTGGAGA
TAGTGTGGAGA -> AGTGTGGAGAG
AGTGTGGAGAG -> GTGTGGAGAGT
GTGTGGAGAGT -> TGTGGAGAGTC
TGTGGAGAGTC -> GTGGAGAGTCT
GTGGAGAGTCT -> TGGAGAGTCTG
TGGAGAGTCTG -> GGAGAGTCTGG
GGAGAGTCTGG -> GAGAGTCTGGC
GAGAGTCTGGC -> AGAGTCTGGCT
AGAGTCTGGCT -> GAGTCTGGCTT
GAGTCTGGCTT -> AGTCTGGCTTA
AGTCTGGCTTA -> GTCTGGCTTAA
GTCTGGCTTAA -> TCTGGCTTAAA
TCTGGCTTAAA -> CTGGCTTAAAT
CTGGCTTAAAT -> TGGCTTAAATT
TGGCTTAAATT -> GGCTTAAATTA
GGCTTAAATTA -> GCTTAAATTAA
GCTTAAATTAA -> CTTAAATTAAA
CTTAAATTAAA -> TTAAATTAAAG
TTAAATTAAAG -> TAAATTAAAGA
TAAATTAAAGA -> AAATTAAAGAC
AAATTAAAGAC -> AATTAAAGACT
AATTAAAGACT -> ATTAAAGACTA
ATTAAAGACTA -> TTAAAGACTAT
TTAAAGACTAT -> TAAAGACTATT
TAAAGACTATT -> AAAGACTATTG
AAAGACTATTG -> AAGACTATTGA
AAGACTATTGA -> AGACTATTGAG
AGACTATTGAG -> GACTATTGAGC
GACTATTGAGC -> ACTATTGAGCT
ACTATTGAGCT -> CTATTGAGCTC
CTATTGAGCTC -> TATTGAGCTCC
TATTGAGCTCC -> ATTGAGCTCCT
ATTGAGCTCCT -> TTGAGCTCCTG
TTGAGCTCCTG -> TGAGCTCCTGG
TGAGCTCCTGG -> GAGCTCCTGGG
GAGCTCCTGGG -> AGCTCCTGGGG
AGCTCCTGGGG -> GCTCCTGGGGC
GCTCCTGGGGC -> CTCCTGGGGCT
CTCCTGGGGCT -> TCCTGGGGCTC
TCCTGGGGCTC -> CCTGGGGCTCT
CCTGGGGCTCT -> CTGGGGCTCTA
CTGGGGCTCTA -> TGGGGCTCTAG
TGGGGCTCTAG -> GGGGCTCTAGC
GGGGCTCTAGC -> GGGCTCTAGCT
GGGCTCTAGCT -> GGCTCTAGCTT
GGCTCTAGCTT -> GCTCTAGCTTG
GCTCTAGCTTG -> CTCTAGCTTGG
CTCTAGCTTGG -> TCTAGCTTGGC
TCTAGCTTGGC -> CTAGCTTGGCG
CTAGCTTGGCG -> TAGCTTGGCGC
TAGCTTGGCGC -> AGCTTGGCGCC
AGCTTGGCGCC -> GCTTGGCGCCC
GCTTGGCGCCC -> CTTGGCGCCCT
CTTGGCGCCCT -> TTGGCGCCCTA
TTGGCGCCCTA -> TGGCGCCCTAT
TGGCGCCCTAT -> GGCGCCCTATT
GGCGCCCTATT -> GCGCCCTATTG
GCGCCCTATTG -> CGCCCTATTGG
CGCCCTATTGG -> GCCCTATTGGT
GCCCTATTGGT -> CCCTATTGGTA
CCCTATTGGTA -> CCTATTGGTAC
CCTATTGGTAC -> CTATTGGTACT
CTATTGGTACT -> TATTGGTACTT
TATTGGTACTT -> ATTGGTACTTT
ATTGGTACTTT -> TTGGTACTTTA
TTGGTACTTTA -> TGGTACTTTAC
TGGTACTTTAC -> GGTACTTTACT
GGTACTTTACT -> GTACTTTACTA
GTACTTTACTA -> TACTTTACTAA
TACTTTACTAA -> ACTTTACTAAG
ACTTTACTAAG -> CTTTACTAAGG
CTTTACTAAGG -> TTTACTAAGGA
TTTACTAAGGA -> TTACTAAGGAT
TTACTAAGGAT -> TACTAAGGATC
TACTAAGGATC -> ACTAAGGATCG
ACTAAGGATCG -> CTAAGGATCGT
CTAAGGATCGT -> TAAGGATCGTA
TAAGGATCGTA -> AAGGATCGTAA
AAGGATCGTAA -> AGGATCGTAAA
AGGATCGTAAA -> GGATCGTAAAG
GGATCGTAAAG -> GATCGTAAAGA
GATCGTAAAGA -> ATCGTAAAGAG
ATCGTAAAGAG -> TCGTAAAGAGA
TCGTAAAGAGA -> CGTAAAGAGAG
CGTAAAGAGAG -> GTAAAGAGAGT
GTAAAGAGAGT -> TAAAGAGAGTA
TAAAGAGAGTA -> AAAGAGAGTAG
AAAGAGAGTAG -> AAGAGAGTAGG
AAGAGAGTAGG -> AGAGAGTAGGT
AGAGAGTAGGT -> GAGAGTAGGTC
GAGAGTAGGTC -> AGAGTAGGTCT
AGAGTAGGTCT -> GAGTAGGTCTA
GAGTAGGTCTA -> AGTAGGTCTAT
AGTAGGTCTAT -> GTAGGTCTATC
GTAGGTCTATC -> TAGGTCTATCA
TAGGTCTATCA -> AGGTCTATCAG
AGGTCTATCAG -> GGTCTATCAGG
GGTCTATCAGG -> GTCTATCAGGG
GTCTATCAGGG -> TCTATCAGGGA
TCTATCAGGGA -> CTATCAGGGAG
CTATCAGGGAG -> TATCAGGGAGC
TATCAGGGAGC -> ATCAGGGAGCG
ATCAGGGAGCG -> TCAGGGAGCGA
TCAGGGAGCGA -> CAGGGAGCGAC
CAGGGAGCGAC -> AGGGAGCGACA
AGGGAGCGACA -> GGGAGCGACAG
GGGAGCGACAG -> GGAGCGACAGA
GGAGCGACAGA -> GAGCGACAGAG
GAGCGACAGAG -> AGCGACAGAGG
AGCGACAGAGG -> GCGACAGAGGT
GCGACAGAGGT -> CGACAGAGGTA
CGACAGAGGTA -> GACAGAGGTAC
GACAGAGGTAC -> ACAGAGGTACT
ACAGAGGTACT -> CAGAGGTACTG
CAGAGGTACTG -> AGAGGTACTGC
AGAGGTACTGC -> GAGGTACTGCG
GAGGTACTGCG -> AGGTACTGCGA
AGGTACTGCGA -> GGTACTGCGAG
GGTACTGCGAG -> GTACTGCGAGC
GTACTGCGAGC -> TACTGCGAGCG
TACTGCGAGCG -> ACTGCGAGCGC
ACTGCGAGCGC -> CTGCGAGCGCC
CTGCGAGCGCC -> TGCGAGCGCCC
TGCGAGCGCCC -> GCGAGCGCCCC
GCGAGCGCCCC -> CGAGCGCCCCA
CGAGCGCCCCA -> GAGCGCCCCAA
GAGCGCCCCAA -> AGCGCCCCAAG
AGCGCCCCAAG -> GCGCCCCAAGT
GCGCCCCAAGT -> CGCCCCAAGTT
CGCCCCAAGTT -> GCCCCAAGTTG
GCCCCAAGTTG -> CCCCAAGTTGC
CCCCAAGTTGC -> CCCAAGTTGCC
CCCAAGTTGCC -> CCAAGTTGCCA
CCAAGTTGCCA -> CAAGTTGCCAG
CAAGTTGCCAG -> AAGTTGCCAGA
AAGTTGCCAGA -> AGTTGCCAGAC
AGTTGCCAGAC -> GTTGCCAGACG
GTTGCCAGACG -> TTGCCAGACGT
TTGCCAGACGT -> TGCCAGACGTT
TGCCAGACGTT -> GCCAGACGTTA
GCCAGACGTTA -> CCAGACGTTAG
CCAGACGTTAG -> CAGACGTTAGA
CAGACGTTAGA -> AGACGTTAGAC
AGACGTTAGAC -> GACGTTAGACA
GACGTTAGACA -> ACGTTAGACAG
ACGTTAGACAG -> CGTTAGACAGC
CGTTAGACAGC -> GTTAGACAGCT
GTTAGACAGCT -> TTAGACAGCTT
TTAGACAGCTT -> TAGACAGCTTC
TAGACAGCTTC -> AGACAGCTTCA
AGACAGCTTCA -> GACAGCTTCAT
GACAGCTTCAT -> ACAGCTTCATA
ACAGCTTCATA -> CAGCTTCATAA
CAGCTTCATAA -> AGCTTCATAAT
AGCTTCATAAT -> GCTTCATAATT
GCTTCATAATT -> CTTCATAATTC
CTTCATAATTC -> TTCATAATTCG
TTCATAATTCG -> TCATAATTCGA
TCATAATTCGA -> CATAATTCGAC
CATAATTCGAC -> ATAATTCGACA
ATAATTCGACA -> TAATTCGACAC
TAATTCGACAC -> AATTCGACACA
AATTCGACACA -> ATTCGACACAG
ATTCGACACAG -> TTCGACACAGC
TTCGACACAGC -> TCGACACAGCA
TCGACACAGCA -> CGACACAGCAG
CGACACAGCAG -> GACACAGCAGA
GACACAGCAGA -> ACACAGCAGAT
ACACAGCAGAT -> CACAGCAGATG
CACAGCAGATG -> ACAGCAGATGA
ACAGCAGATGA -> CAGCAGATGAT
CAGCAGATGAT -> AGCAGATGATG
AGCAGATGATG -> GCAGATGATGT
GCAGATGATGT -> CAGATGATGTC
CAGATGATGTC -> AGATGATGTCC
AGATGATGTCC -> GATGATGTCCG
GATGATGTCCG -> ATGATGTCCGT
ATGATGTCCGT -> TGATGTCCGTA
TGATGTCCGTA -> GATGTCCGTAA
GATGTCCGTAA -> ATGTCCGTAAC
ATGTCCGTAAC -> TGTCCGTAACA
TGTCCGTAACA -> GTCCGTAACAC
GTCCGTAACAC -> TCCGTAACACA
TCCGTAACACA -> CCGTAACACAC
CCGTAACACAC -> CGTAACACACG
CGTAACACACG -> GTAACACACGA
GTAACACACGA -> TAACACACGAG
TAACACACGAG -> AACACACGAGC
AACACACGAGC -> ACACACGAGCG
ACACACGAGCG -> CACACGAGCGT
CACACGAGCGT -> ACACGAGCGTA
ACACGAGCGTA -> CACGAGCGTAC
CACGAGCGTAC -> ACGAGCGTACA
ACGAGCGTACA -> CGAGCGTACAT
CGAGCGTACAT -> GAGCGTACATA
GAGCGTACATA -> AGCGTACATAC
AGCGTACATAC -> GCGTACATACG
GCGTACATACG -> CGTACATACGC
CGTACATACGC -> GTACATACGCG
GTACATACGCG -> TACATACGCGA
TACATACGCGA -> ACATACGCGAC
ACATACGCGAC -> CATACGCGACC
CATACGCGACC -> ATACGCGACCA
ATACGCGACCA -> TACGCGACCAC
TACGCGACCAC -> ACGCGACCACA
ACGCGACCACA -> CGCGACCACAA
CGCGACCACAA -> GCGACCACAAG
GCGACCACAAG -> CGACCACAAGA
CGACCACAAGA -> GACCACAAGAG
GACCACAAGAG -> ACCACAAGAGT
ACCACAAGAGT -> CCACAAGAGTT
CCACAAGAGTT -> CACAAGAGTTA
CACAAGAGTTA -> ACAAGAGTTAA
ACAAGAGTTAA -> CAAGAGTTAAC
CAAGAGTTAAC -> AAGAGTTAACA
AAGAGTTAACA -> AGAGTTAACAG
AGAGTTAACAG -> GAGTTAACAGA
GAGTTAACAGA -> AGTTAACAGAG
AGTTAACAGAG -> GTTAACAGAGG
GTTAACAGAGG -> TTAACAGAGGA
TTAACAGAGGA -> TAACAGAGGAA
TAACAGAGGAA -> AACAGAGGAAT
AACAGAGGAAT -> ACAGAGGAATC
ACAGAGGAATC -> CAGAGGAATCT
CAGAGGAATCT -> AGAGGAATCTT
AGAGGAATCTT -> GAGGAATCTTC
GAGGAATCTTC -> AGGAATCTTCT
AGGAATCTTCT -> GGAATCTTCTA
GGAATCTTCTA -> GAATCTTCTAA
GAATCTTCTAA -> AATCTTCTAAA
AATCTTCTAAA -> ATCTTCTAAAT
ATCTTCTAAAT -> TCTTCTAAATT
TCTTCTAAATT -> CTTCTAAATTG
CTTCTAAATTG -> TTCTAAATTGT
TTCTAAATTGT -> TCTAAATTGTC
TCTAAATTGTC -> CTAAATTGTCC
CTAAATTGTCC -> TAAATTGTCCA
TAAATTGTCCA -> AAATTGTCCAT
AAATTGTCCAT -> AATTGTCCATG
AATTGTCCATG -> ATTGTCCATGT
ATTGTCCATGT -> TTGTCCATGTG
TTGTCCATGTG -> TGTCCATGTGG
TGTCCATGTGG -> GTCCATGTGGA
GTCCATGTGGA -> TCCATGTGGAG
TCCATGTGGAG -> CCATGTGGAGG
CCATGTGGAGG -> CATGTGGAGGG
CATGTGGAGGG -> ATGTGGAGGGG
ATGTGGAGGGG -> TGTGGAGGGGG
TGTGGAGGGGG -> GTGGAGGGGGT
GTGGAGGGGGT -> TGGAGGGGGTC
TGGAGGGGGTC -> GGAGGGGGTCG
GGAGGGGGTCG -> GAGGGGGTCGT
GAGGGGGTCGT -> AGGGGGTCGTT
AGGGGGTCGTT -> GGGGGTCGTTA
GGGGGTCGTTA -> GGGGTCGTTAA
GGGGTCGTTAA -> GGGTCGTTAAA
GGGTCGTTAAA -> GGTCGTTAAAC
GGTCGTTAAAC -> GTCGTTAAACA
GTCGTTAAACA -> TCGTTAAACAA
TCGTTAAACAA -> CGTTAAACAAC
CGTTAAACAAC -> GTTAAACAACC
GTTAAACAACC -> TTAAACAACCT
TTAAACAACCT -> TAAACAACCTT
TAAACAACCTT -> AAACAACCTTC
AAACAACCTTC -> AACAACCTTCG
AACAACCTTCG -> ACAACCTTCGG
ACAACCTTCGG -> CAACCTTCGGT
CAACCTTCGGT -> AACCTTCGGTG
AACCTTCGGTG -> ACCTTCGGTGA
ACCTTCGGTGA -> CCTTCGGTGAA
CCTTCGGTGAA -> CTTCGGTGAAT
CTTCGGTGAAT -> TTCGGTGAATG
TTCGGTGAATG -> TCGGTGAATGC
TCGGTGAATGC -> CGGTGAATGCG
CGGTGAATGCG -> GGTGAATGCGG
GGTGAATGCGG -> GTGAATGCGGA
GTGAATGCGGA -> TGAATGCGGAT
TGAATGCGGAT -> GAATGCGGATG
GAATGCGGATG -> AATGCGGATGG
AATGCGGATGG -> ATGCGGATGGA
ATGCGGATGGA -> TGCGGATGGAT
TGCGGATGGAT -> GCGGATGGATT
GCGGATGGATT -> CGGATGGATTC
CGGATGGATTC -> GGATGGATTCG
GGATGGATTCG -> GATGGATTCGG
GATGGATTCGG -> ATGGATTCGGC
ATGGATTCGGC -> TGGATTCGGCT
TGGATTCGGCT -> GGATTCGGCTA
GGATTCGGCTA -> GATTCGGCTAG
GATTCGGCTAG -> ATTCGGCTAGG
ATTCGGCTAGG -> TTCGGCTAGGA
TTCGGCTAGGA -> TCGGCTAGGAG
TCGGCTAGGAG -> CGGCTAGGAGA
CGGCTAGGAGA -> GGCTAGGAGAC
GGCTAGGAGAC -> GCTAGGAGACC
GCTAGGAGACC -> CTAGGAGACCC
CTAGGAGACCC -> TAGGAGACCCG
TAGGAGACCCG -> AGGAGACCCGT
AGGAGACCCGT -> GGAGACCCGTG
GGAGACCCGTG -> GAGACCCGTGT
GAGACCCGTGT -> AGACCCGTGTA
AGACCCGTGTA -> GACCCGTGTAC
GACCCGTGTAC -> ACCCGTGTACA
ACCCGTGTACA -> CCCGTGTACAC
CCCGTGTACAC -> CCGTGTACACT
CCGTGTACACT -> CGTGTACACTT
CGTGTACACTT -> GTGTACACTTT
GTGTACACTTT -> TGTACACTTTG
TGTACACTTTG -> GTACACTTTGA
GTACACTTTGA -> TACACTTTGAA
TACACTTTGAA -> ACACTTTGAAG
ACACTTTGAAG -> CACTTTGAAGG
CACTTTGAAGG -> ACTTTGAAGGA
ACTTTGAAGGA -> CTTTGAAGGAG
CTTTGAAGGAG -> TTTGAAGGAGC
TTTGAAGGAGC -> TTGAAGGAGCT
TTGAAGGAGCT -> TGAAGGAGCTG
TGAAGGAGCTG -> GAAGGAGCTGT
GAAGGAGCTGT -> AAGGAGCTGTG
AAGGAGCTGTG -> AGGAGCTGTGG
AGGAGCTGTGG -> GGAGCTGTGGC
GGAGCTGTGGC -> GAGCTGTGGCC
GAGCTGTGGCC -> AGCTGTGGCCG
AGCTGTGGCCG -> GCTGTGGCCGT
GCTGTGGCCGT -> CTGTGGCCGTG
CTGTGGCCGTG -> TGTGGCCGTGG
TGTGGCCGTGG -> GTGGCCGTGGT
GTGGCCGTGGT -> TGGCCGTGGTG
TGGCCGTGGTG -> GGCCGTGGTGT
GGCCGTGGTGT -> GCCGTGGTGTT
GCCGTGGTGTT -> CCGTGGTGTTA
CCGTGGTGTTA -> CGTGGTGTTAT
CGTGGTGTTAT -> GTGGTGTTATG
GTGGTGTTATG -> TGGTGTTATGC
TGGTGTTATGC -> GGTGTTATGCA
GGTGTTATGCA -> GTGTTATGCAC
GTGTTATGCAC -> TGTTATGCACT
TGTTATGCACT -> GTTATGCACTA
GTTATGCACTA -> TTATGCACTAT
TTATGCACTAT -> TATGCACTATC
TATGCACTATC -> ATGCACTATCA
ATGCACTATCA -> TGCACTATCAG
TGCACTATCAG -> GCACTATCAGT
GCACTATCAGT -> CACTATCAGTA
CACTATCAGTA -> ACTATCAGTAT
ACTATCAGTAT -> CTATCAGTATC
CTATCAGTATC -> TATCAGTATCC
TATCAGTATCC -> ATCAGTATCCA
ATCAGTATCCA -> TCAGTATCCAA
TCAGTATCCAA -> CAGTATCCAAG
CAGTATCCAAG -> AGTATCCAAGG
AGTATCCAAGG -> GTATCCAAGGG
GTATCCAAGGG -> TATCCAAGGGC
TATCCAAGGGC -> ATCCAAGGGCC
ATCCAAGGGCC -> TCCAAGGGCCA
TCCAAGGGCCA -> CCAAGGGCCAC
CCAAGGGCCAC -> CAAGGGCCACT
CAAGGGCCACT -> AAGGGCCACTT
AAGGGCCACTT -> AGGGCCACTTC
AGGGCCACTTC -> GGGCCACTTCT
GGGCCACTTCT -> GGCCACTTCTG
GGCCACTTCTG -> GCCACTTCTGT
GCCACTTCTGT -> CCACTTCTGTT
CCACTTCTGTT -> CACTTCTGTTT
CACTTCTGTTT -> ACTTCTGTTTC
ACTTCTGTTTC -> CTTCTGTTTCA
CTTCTGTTTCA -> TTCTGTTTCAT
TTCTGTTTCAT -> TCTGTTTCATG
TCTGTTTCATG -> CTGTTTCATGC
CTGTTTCATGC -> TGTTTCATGCC
TGTTTCATGCC -> GTTTCATGCCA
GTTTCATGCCA -> TTTCATGCCAG
TTTCATGCCAG -> TTCATGCCAGA
TTCATGCCAGA -> TCATGCCAGAA
TCATGCCAGAA -> CATGCCAGAAA
CATGCCAGAAA -> ATGCCAGAAAT
ATGCCAGAAAT -> TGCCAGAAATC
TGCCAGAAATC -> GCCAGAAATCA
GCCAGAAATCA -> CCAGAAATCAT
CCAGAAATCAT -> CAGAAATCATC
CAGAAATCATC -> AGAAATCATCT
AGAAATCATCT -> GAAATCATCTC
GAAATCATCTC -> AAATCATCTCG
AAATCATCTCG -> AATCATCTCGG
AATCATCTCGG -> ATCATCTCGGT
ATCATCTCGGT -> TCATCTCGGTT
TCATCTCGGTT -> CATCTCGGTTG
CATCTCGGTTG -> ATCTCGGTTGA
ATCTCGGTTGA -> TCTCGGTTGAC
TCTCGGTTGAC -> CTCGGTTGACA
CTCGGTTGACA -> TCGGTTGACAC
TCGGTTGACAC -> CGGTTGACACC
CGGTTGACACC -> GGTTGACACCC
GGTTGACACCC -> GTTGACACCCT
GTTGACACCCT -> TTGACACCCTC
TTGACACCCTC -> TGACACCCTCG
TGACACCCTCG -> GACACCCTCGT
GACACCCTCGT -> ACACCCTCGTG
ACACCCTCGTG -> CACCCTCGTGT
CACCCTCGTGT -> ACCCTCGTGTG
ACCCTCGTGTG -> CCCTCGTGTGT
CCCTCGTGTGT -> CCTCGTGTGTT
CCTCGTGTGTT -> CTCGTGTGTTG
CTCGTGTGTTG -> TCGTGTGTTGA
TCGTGTGTTGA -> CGTGTGTTGAG
CGTGTGTTGAG -> GTGTGTTGAGT
GTGTGTTGAGT -> TGTGTTGAGTC
TGTGTTGAGTC -> GTGTTGAGTCG
GTGTTGAGTCG -> TGTTGAGTCGT
TGTTGAGTCGT -> GTTGAGTCGTG
GTTGAGTCGTG -> TTGAGTCGTGT
TTGAGTCGTGT -> TGAGTCGTGTC
TGAGTCGTGTC -> GAGTCGTGTCA
GAGTCGTGTCA -> AGTCGTGTCAG
AGTCGTGTCAG -> GTCGTGTCAGA
GTCGTGTCAGA -> TCGTGTCAGAG
TCGTGTCAGAG -> CGTGTCAGAGA
CGTGTCAGAGA -> GTGTCAGAGAC
GTGTCAGAGAC -> TGTCAGAGACT
TGTCAGAGACT -> GTCAGAGACTA
GTCAGAGACTA -> TCAGAGACTAA
TCAGAGACTAA -> CAGAGACTAAA
CAGAGACTAAA -> AGAGACTAAAC
AGAGACTAAAC -> GAGACTAAACT
GAGACTAAACT -> AGACTAAACTA
AGACTAAACTA -> GACTAAACTAG
GACTAAACTAG -> ACTAAACTAGG
ACTAAACTAGG -> CTAAACTAGGT
CTAAACTAGGT -> TAAACTAGGTC
TAAACTAGGTC -> AAACTAGGTCT
AAACTAGGTCT -> AACTAGGTCTC
AACTAGGTCTC -> ACTAGGTCTCT
ACTAGGTCTCT -> CTAGGTCTCTT
CTAGGTCTCTT -> TAGGTCTCTTT
TAGGTCTCTTT -> AGGTCTCTTTG
AGGTCTCTTTG -> GGTCTCTTTGT
GGTCTCTTTGT -> GTCTCTTTGTA
GTCTCTTTGTA -> TCTCTTTGTAG
TCTCTTTGTAG -> CTCTTTGTAGA
CTCTTTGTAGA -> TCTTTGTAGAA
TCTTTGTAGAA -> CTTTGTAGAAG
CTTTGTAGAAG -> TTTGTAGAAGG
TTTGTAGAAGG -> TTGTAGAAGGA
TTGTAGAAGGA -> TGTAGAAGGAT
TGTAGAAGGAT -> GTAGAAGGATC
GTAGAAGGATC -> TAGAAGGATCG
TAGAAGGATCG -> AGAAGGATCGG
AGAAGGATCGG -> GAAGGATCGGA
GAAGGATCGGA -> AAGGATCGGAT
AAGGATCGGAT -> AGGATCGGATT
AGGATCGGATT -> GGATCGGATTA
GGATCGGATTA -> GATCGGATTAC
GATCGGATTAC -> ATCGGATTACA
ATCGGATTACA -> TCGGATTACAA
TCGGATTACAA -> CGGATTACAAG
CGGATTACAAG -> GGATTACAAGG
GGATTACAAGG -> GATTACAAGGT
GATTACAAGGT -> ATTACAAGGTC
ATTACAAGGTC -> TTACAAGGTCC
TTACAAGGTCC -> TACAAGGTCCC
TACAAGGTCCC -> ACAAGGTCCCT
ACAAGGTCCCT -> CAAGGTCCCTA
CAAGGTCCCTA -> AAGGTCCCTAG
AAGGTCCCTAG -> AGGTCCCTAGG
AGGTCCCTAGG -> GGTCCCTAGGG
GGTCCCTAGGG -> GTCCCTAGGGA
GTCCCTAGGGA -> TCCCTAGGGAT
TCCCTAGGGAT -> CCCTAGGGATG
CCCTAGGGATG -> CCTAGGGATGT
CCTAGGGATGT -> CTAGGGATGTG
CTAGGGATGTG -> TAGGGATGTGG
TAGGGATGTGG -> AGGGATGTGGG
AGGGATGTGGG -> GGGATGTGGGC
GGATGTGGGCA -> GATGTGGGCAA
GATGTGGGCAA -> ATGTGGGCAAT
ATGTGGGCAAT -> TGTGGGCAATC
TGTGGGCAATC -> GTGGGCAATCG
GTGGGCAATCG -> TGGGCAATCGA
TGGGCAATCGA -> GGGCAATCGAG
GGGCAATCGAG -> GGCAATCGAGG
GGCAATCGAGG -> GCAATCGAGGT
GCAATCGAGGT -> CAATCGAGGTA
CAATCGAGGTA -> AATCGAGGTAC
AATCGAGGTAC -> ATCGAGGTACA
ATCGAGGTACA -> TCGAGGTACAC
TCGAGGTACAC -> CGAGGTACACA
CGAGGTACACA -> GAGGTACACAC
GAGGTACACAC -> AGGTACACACA
AGGTACACACA -> GGTACACACAA
GGTACACACAA -> GTACACACAAT
GTACACACAAT -> TACACACAATC
TACACACAATC -> ACACACAATCC
ACACACAATCC -> CACACAATCCA
CACACAATCCA -> ACACAATCCAT
ACACAATCCAT -> CACAATCCATG
CACAATCCATG -> ACAATCCATGG
ACAATCCATGG -> CAATCCATGGC
CAATCCATGGC -> AATCCATGGCT
AATCCATGGCT -> ATCCATGGCTA
ATCCATGGCTA -> TCCATGGCTAA
TCCATGGCTAA -> CCATGGCTAAC
CCATGGCTAAC -> CATGGCTAACA
CATGGCTAACA -> ATGGCTAACAG
ATGGCTAACAG -> TGGCTAACAGG
TGGCTAACAGG -> GGCTAACAGGT
GGCTAACAGGT -> GCTAACAGGTA
GCTAACAGGTA -> CTAACAGGTAA
CTAACAGGTAA -> TAACAGGTAAG
TAACAGGTAAG -> AACAGGTAAGT
AACAGGTAAGT -> ACAGGTAAGTG
ACAGGTAAGTG -> CAGGTAAGTGG
CAGGTAAGTGG -> AGGTAAGTGGG
AGGTAAGTGGG -> GGTAAGTGGGG
GGTAAGTGGGG -> GTAAGTGGGGG
GTAAGTGGGGG -> TAAGTGGGGGA
TAAGTGGGGGA -> AAGTGGGGGAG
AAGTGGGGGAG -> AGTGGGGGAGG
AGTGGGGGAGG -> GTGGGGGAGGA
GTGGGGGAGGA -> TGGGGGAGGAG
TGGGGGAGGAG -> GGGGGAGGAGT
GGGGGAGGAGT -> GGGGAGGAGTG
GGGGAGGAGTG -> GGGAGGAGTGG
GGGAGGAGTGG -> GGAGGAGTGGG
GGAGGAGTGGG -> GAGGAGTGGGC
GAGGAGTGGGC -> AGGAGTGGGCG
AGGAGTGGGCG -> GGAGTGGGCGA
GGAGTGGGCGA -> GAGTGGGCGAG
GAGTGGGCGAG -> AGTGGGCGAGT
AGTGGGCGAGT -> GTGGGCGAGTA
GTGGGCGAGTA -> TGGGCGAGTAT
TGGGCGAGTAT -> GGGCGAGTATA
GGGCGAGTATA -> GGCGAGTATAC
GGCGAGTATAC -> GCGAGTATACC
GCGAGTATACC -> CGAGTATACCG
CGAGTATACCG -> GAGTATACCGG
GAGTATACCGG -> AGTATACCGGT
AGTATACCGGT -> GTATACCGGTA
GTATACCGGTA -> TATACCGGTAG
TATACCGGTAG -> ATACCGGTAGG
ATACCGGTAGG -> TACCGGTAGGG
TACCGGTAGGG -> ACCGGTAGGGT
ACCGGTAGGGT -> CCGGTAGGGTA
CCGGTAGGGTA -> CGGTAGGGTAA
CGGTAGGGTAA -> GGTAGGGTAAG
GGTAGGGTAAG -> GTAGGGTAAGT
GTAGGGTAAGT -> TAGGGTAAGTT
TAGGGTAAGTT -> AGGGTAAGTTA
AGGGTAAGTTA -> GGGTAAGTTAC
GGGTAAGTTAC -> GGTAAGTTACC
GGTAAGTTACC -> GTAAGTTACCT
GTAAGTTACCT -> TAAGTTACCTA
TAAGTTACCTA -> AAGTTACCTAT
AAGTTACCTAT -> AGTTACCTATC
AGTTACCTATC -> GTTACCTATCG
GTTACCTATCG -> TTACCTATCGT
TTACCTATCGT -> TACCTATCGTG
TACCTATCGTG -> ACCTATCGTGA
ACCTATCGTGA -> CCTATCGTGAG
CCTATCGTGAG -> CTATCGTGAGA
CTATCGTGAGA -> TATCGTGAGAA
TATCGTGAGAA -> ATCGTGAGAAC
ATCGTGAGAAC -> TCGTGAGAACT
TCGTGAGAACT -> CGTGAGAACTG
CGTGAGAACTG -> GTGAGAACTGT
GTGAGAACTGT -> TGAGAACTGTC
TGAGAACTGTC -> GAGAACTGTCT
GAGAACTGTCT -> AGAACTGTCTG
AGAACTGTCTG -> GAACTGTCTGA
GAACTGTCTGA -> AACTGTCTGAT
AACTGTCTGAT -> ACTGTCTGATG
ACTGTCTGATG -> CTGTCTGATGC
CTGTCTGATGC -> TGTCTGATGCG
TGTCTGATGCG -> GTCTGATGCGT
GTCTGATGCGT -> TCTGATGCGTG
TCTGATGCGTG -> CTGATGCGTGT
CTGATGCGTGT -> TGATGCGTGTC
TGATGCGTGTC -> GATGCGTGTCA
GATGCGTGTCA -> ATGCGTGTCAA
ATGCGTGTCAA -> TGCGTGTCAAC
TGCGTGTCAAC -> GCGTGTCAACC
GCGTGTCAACC -> CGTGTCAACCG
CGTGTCAACCG -> GTGTCAACCGA
GTGTCAACCGA -> TGTCAACCGAA
TGTCAACCGAA -> GTCAACCGAAG
GTCAACCGAAG -> TCAACCGAAGT
TCAACCGAAGT -> CAACCGAAGTC
CAACCGAAGTC -> AACCGAAGTCT
AACCGAAGTCT -> ACCGAAGTCTT
ACCGAAGTCTT -> CCGAAGTCTTG
CCGAAGTCTTG -> CGAAGTCTTGC
CGAAGTCTTGC -> GAAGTCTTGCA
GAAGTCTTGCA -> AAGTCTTGCAT
AAGTCTTGCAT -> AGTCTTGCATG
AGTCTTGCATG -> GTCTTGCATGA
GTCTTGCATGA -> TCTTGCATGAC
TCTTGCATGAC -> CTTGCATGACC
CTTGCATGACC -> TTGCATGACCT
TTGCATGACCT -> TGCATGACCTC
TGCATGACCTC -> GCATGACCTCC
GCATGACCTCC -> CATGACCTCCT
CATGACCTCCT -> ATGACCTCCTA
ATGACCTCCTA -> TGACCTCCTAT
TGACCTCCTAT -> GACCTCCTATA
GACCTCCTATA -> ACCTCCTATAG
ACCTCCTATAG -> CCTCCTATAGG
CCTCCTATAGG -> CTCCTATAGGT
CTCCTATAGGT -> TCCTATAGGTA
TCCTATAGGTA -> CCTATAGGTAA
CCTATAGGTAA -> CTATAGGTAAG
CTATAGGTAAG -> TATAGGTAAGG
TATAGGTAAGG -> ATAGGTAAGGT
ATAGGTAAGGT -> TAGGTAAGGTA
TAGGTAAGGTA -> AGGTAAGGTAC
AGGTAAGGTAC -> GGTAAGGTACC
GGTAAGGTACC -> GTAAGGTACCA
GTAAGGTACCA -> TAAGGTACCAA
TAAGGTACCAA -> AAGGTACCAAT
AAGGTACCAAT -> AGGTACCAATG
AGGTACCAATG -> GGTACCAATGC
GGTACCAATGC -> GTACCAATGCG
GTACCAATGCG -> TACCAATGCGT
TACCAATGCGT -> ACCAATGCGTG
ACCAATGCGTG -> CCAATGCGTGT
CCAATGCGTGT -> CAATGCGTGTA
CAATGCGTGTA -> AATGCGTGTAG
AATGCGTGTAG -> ATGCGTGTAGG
ATGCGTGTAGG -> TGCGTGTAGGT
TGCGTGTAGGT -> GCGTGTAGGTT
GCGTGTAGGTT -> CGTGTAGGTTT
CGTGTAGGTTT -> GTGTAGGTTTA
GTGTAGGTTTA -> TGTAGGTTTAT
TGTAGGTTTAT -> GTAGGTTTATT
GTAGGTTTATT -> TAGGTTTATTC
TAGGTTTATTC -> AGGTTTATTCC
AGGTTTATTCC -> GGTTTATTCCA
GGTTTATTCCA -> GTTTATTCCAA
GTTTATTCCAA -> TTTATTCCAAA
TTTATTCCAAA -> TTATTCCAAAC
TTATTCCAAAC -> TATTCCAAACT
TATTCCAAACT -> ATTCCAAACTT
ATTCCAAACTT -> TTCCAAACTTT
TTCCAAACTTT -> TCCAAACTTTT
TCCAAACTTTT -> CCAAACTTTTA
CCAAACTTTTA -> CAAACTTTTAC
CAAACTTTTAC -> AAACTTTTACC
AAACTTTTACC -> AACTTTTACCC
AACTTTTACCC -> ACTTTTACCCC
ACTTTTACCCC -> CTTTTACCCCC
CTTTTACCCCC -> TTTTACCCCCG
TTTTACCCCCG -> TTTACCCCCGT
TTTACCCCCGT -> TTACCCCCGTA
TTACCCCCGTA -> TACCCCCGTAA
TACCCCCGTAA -> ACCCCCGTAAT
ACCCCCGTAAT -> CCCCCGTAATG
CCCCCGTAATG -> CCCCGTAATGG
CCCCGTAATGG -> CCCGTAATGGT
CCCGTAATGGT -> CCGTAATGGTA
CCGTAATGGTA -> CGTAATGGTAT
CGTAATGGTAT -> GTAATGGTATT
GTAATGGTATT -> TAATGGTATTA
TAATGGTATTA -> AATGGTATTAA
AATGGTATTAA -> ATGGTATTAAA
ATGGTATTAAA -> TGGTATTAAAT
TGGTATTAAAT -> GGTATTAAATC
GGTATTAAATC -> GTATTAAATCT
GTATTAAATCT -> TATTAAATCTC
TATTAAATCTC -> ATTAAATCTCG
ATTAAATCTCG -> TTAAATCTCGG
TTAAATCTCGG -> TAAATCTCGGA
TAAATCTCGGA -> AAATCTCGGAA
AAATCTCGGAA -> AATCTCGGAAC
AATCTCGGAAC -> ATCTCGGAACG
ATCTCGGAACG -> TCTCGGAACGT
TCTCGGAACGT -> CTCGGAACGTA
CTCGGAACGTA -> TCGGAACGTAT
TCGGAACGTAT -> CGGAACGTATT
CGGAACGTATT -> GGAACGTATTA
GGAACGTATTA -> GAACGTATTAT
GAACGTATTAT -> AACGTATTATA
AACGTATTATA -> ACGTATTATAC
ACGTATTATAC -> CGTATTATACA
CGTATTATACA -> GTATTATACAC
GTATTATACAC -> TATTATACACT
TATTATACACT -> ATTATACACTG
ATTATACACTG -> TTATACACTGC
TTATACACTGC -> TATACACTGCC
TATACACTGCC -> ATACACTGCCT
ATACACTGCCT -> TACACTGCCTC
TACACTGCCTC -> ACACTGCCTCG
ACACTGCCTCG -> CACTGCCTCGT
CACTGCCTCGT -> ACTGCCTCGTA
ACTGCCTCGTA -> CTGCCTCGTAT
CTGCCTCGTAT -> TGCCTCGTATA
TGCCTCGTATA -> GCCTCGTATAC
GCCTCGTATAC -> CCTCGTATACT
CCTCGTATACT -> CTCGTATACTC
CTCGTATACTC -> TCGTATACTCA
TCGTATACTCA -> CGTATACTCAC
CGTATACTCAC -> GTATACTCACT
GTATACTCACT -> TATACTCACTG
TATACTCACTG -> ATACTCACTGT
ATACTCACTGT -> TACTCACTGTG
TACTCACTGTG -> ACTCACTGTGA
ACTCACTGTGA -> CTCACTGTGAT
CTCACTGTGAT -> TCACTGTGATA
TCACTGTGATA -> CACTGTGATAT
CACTGTGATAT -> ACTGTGATATT
ACTGTGATATT -> CTGTGATATTG
CTGTGATATTG -> TGTGATATTGC
TGTGATATTGC -> GTGATATTGCC
GTGATATTGCC -> TGATATTGCCG
TGATATTGCCG -> GATATTGCCGC
GATATTGCCGC -> ATATTGCCGCT
ATATTGCCGCT -> TATTGCCGCTG
TATTGCCGCTG -> ATTGCCGCTGC
ATTGCCGCTGC -> TTGCCGCTGCT
TTGCCGCTGCT -> TGCCGCTGCTA
TGCCGCTGCTA -> GCCGCTGCTAC
GCCGCTGCTAC -> CCGCTGCTACC
CCGCTGCTACC -> CGCTGCTACCC
CGCTGCTACCC -> GCTGCTACCCA
GCTGCTACCCA -> CTGCTACCCAA
CTGCTACCCAA -> TGCTACCCAAG
TGCTACCCAAG -> GCTACCCAAGA
GCTACCCAAGA -> CTACCCAAGAC
CTACCCAAGAC -> TACCCAAGACG
TACCCAAGACG -> ACCCAAGACGA
ACCCAAGACGA -> CCCAAGACGAC
CCCAAGACGAC -> CCAAGACGACA
CCAAGACGACA -> CAAGACGACAT
CAAGACGACAT -> AAGACGACATC
AAGACGACATC -> AGACGACATCG
AGACGACATCG -> GACGACATCGC
GACGACATCGC -> ACGACATCGCG
ACGACATCGCG -> CGACATCGCGG
CGACATCGCGG -> GACATCGCGGA
GACATCGCGGA -> ACATCGCGGAC
ACATCGCGGAC -> CATCGCGGACA
CATCGCGGACA -> ATCGCGGACAA
ATCGCGGACAA -> TCGCGGACAAT
TCGCGGACAAT -> CGCGGACAATA
CGCGGACAATA -> GCGGACAATAT
GCGGACAATAT -> CGGACAATATG
CGGACAATATG -> GGACAATATGC
GGACAATATGC -> GACAATATGCA
GACAATATGCA -> ACAATATGCAG
ACAATATGCAG -> CAATATGCAGC
CAATATGCAGC -> AATATGCAGCA
AATATGCAGCA -> ATATGCAGCAC
ATATGCAGCAC -> TATGCAGCACC
TATGCAGCACC -> ATGCAGCACCT
ATGCAGCACCT -> TGCAGCACCTA
TGCAGCACCTA -> GCAGCACCTAG
GCAGCACCTAG -> CAGCACCTAGA
CAGCACCTAGA -> AGCACCTAGAC
AGCACCTAGAC -> GCACCTAGACT
GCACCTAGACT -> CACCTAGACTC
CACCTAGACTC -> ACCTAGACTCT
ACCTAGACTCT -> CCTAGACTCTC
CCTAGACTCTC -> CTAGACTCTCC
CTAGACTCTCC -> TAGACTCTCCC
TAGACTCTCCC -> AGACTCTCCCA
AGACTCTCCCA -> GACTCTCCCAT
GACTCTCCCAT -> ACTCTCCCATT
ACTCTCCCATT -> CTCTCCCATTG
CTCTCCCATTG -> TCTCCCATTGG
TCTCCCATTGG -> CTCCCATTGGC
CTCCCATTGGC -> TCCCATTGGCT
TCCCATTGGCT -> CCCATTGGCTT
CCCATTGGCTT -> CCATTGGCTTT
CCATTGGCTTT -> CATTGGCTTTG
CATTGGCTTTG -> ATTGGCTTTGC
ATTGGCTTTGC -> TTGGCTTTGCT
TTGGCTTTGCT -> TGGCTTTGCTT
TGGCTTTGCTT -> GGCTTTGCTTA
GGCTTTGCTTA -> GCTTTGCTTAG
GCTTTGCTTAG -> CTTTGCTTAGC
CTTTGCTTAGC -> TTTGCTTAGCC
TTTGCTTAGCC -> TTGCTTAGCCT
TTGCTTAGCCT -> TGCTTAGCCTC
TGCTTAGCCTC -> GCTTAGCCTCG
GCTTAGCCTCG -> CTTAGCCTCGG
CTTAGCCTCGG -> TTAGCCTCGGC
TTAGCCTCGGC -> TAGCCTCGGCC
TAGCCTCGGCC -> AGCCTCGGCCG
AGCCTCGGCCG -> GCCTCGGCCGG
GCCTCGGCCGG -> CCTCGGCCGGG
CCTCGGCCGGG -> CTCGGCCGGGA
CTCGGCCGGGA -> TCGGCCGGGAT
TCGGCCGGGAT -> CGGCCGGGATG
CGGCCGGGATG -> GGCCGGGATGA
GGCCGGGATGA -> GCCGGGATGAG
GCCGGGATGAG -> CCGGGATGAGC
CCGGGATGAGC -> CGGGATGAGCA
CGGGATGAGCA -> GGGATGAGCAA
GGGATGAGCAA -> GGATGAGCAAC
GGATGAGCAAC -> GATGAGCAACG
GATGAGCAACG -> ATGAGCAACGC
ATGAGCAACGC -> TGAGCAACGCT
TGAGCAACGCT -> GAGCAACGCTC
GAGCAACGCTC -> AGCAACGCTCG
AGCAACGCTCG -> GCAACGCTCGT
GCAACGCTCGT -> CAACGCTCGTC
CAACGCTCGTC -> AACGCTCGTCT
AACGCTCGTCT -> ACGCTCGTCTC
ACGCTCGTCTC -> CGCTCGTCTCT
CGCTCGTCTCT -> GCTCGTCTCTT
GCTCGTCTCTT -> CTCGTCTCTTT
CTCGTCTCTTT -> TCGTCTCTTTG
TCGTCTCTTTG -> CGTCTCTTTGG
CGTCTCTTTGG -> GTCTCTTTGGC
GTCTCTTTGGC -> TCTCTTTGGCC
TCTCTTTGGCC -> CTCTTTGGCCA
CTCTTTGGCCA -> TCTTTGGCCAC
TCTTTGGCCAC -> CTTTGGCCACT
CTTTGGCCACT -> TTTGGCCACTT
TTTGGCCACTT -> TTGGCCACTTG
TTGGCCACTTG -> TGGCCACTTGA
TGGCCACTTGA -> GGCCACTTGAT
GGCCACTTGAT -> GCCACTTGATT
GCCACTTGATT -> CCACTTGATTG
CCACTTGATTG -> CACTTGATTGT
CACTTGATTGT -> ACTTGATTGTC
ACTTGATTGTC -> CTTGATTGTCT
CTTGATTGTCT -> TTGATTGTCTA
TTGATTGTCTA -> TGATTGTCTAA
TGATTGTCTAA -> GATTGTCTAAT
GATTGTCTAAT -> ATTGTCTAATC
ATTGTCTAATC -> TTGTCTAATCG
TTGTCTAATCG -> TGTCTAATCGA
TGTCTAATCGA -> GTCTAATCGAT
GTCTAATCGAT -> TCTAATCGATA
TCTAATCGATA -> CTAATCGATAA
CTAATCGATAA -> TAATCGATAAG
TAATCGATAAG -> AATCGATAAGC
AATCGATAAGC -> ATCGATAAGCG
ATCGATAAGCG -> TCGATAAGCGA
TCGATAAGCGA -> CGATAAGCGAA
CGATAAGCGAA -> GATAAGCGAAT
GATAAGCGAAT -> ATAAGCGAATT
ATAAGCGAATT -> TAAGCGAATTG
TAAGCGAATTG -> AAGCGAATTGT
AAGCGAATTGT -> AGCGAATTGTA
AGCGAATTGTA -> GCGAATTGTAC
GCGAATTGTAC -> CGAATTGTACA
CGAATTGTACA -> GAATTGTACAA
GAATTGTACAA -> AATTGTACAAC
AATTGTACAAC -> ATTGTACAACG
ATTGTACAACG -> TTGTACAACGG
TTGTACAACGG -> TGTACAACGGT
TGTACAACGGT -> GTACAACGGTT
GTACAACGGTT -> TACAACGGTTG
TACAACGGTTG -> ACAACGGTTGC
ACAACGGTTGC -> CAACGGTTGCT
CAACGGTTGCT -> AACGGTTGCTT
AACGGTTGCTT -> ACGGTTGCTTC
ACGGTTGCTTC -> CGGTTGCTTCA
CGGTTGCTTCA -> GGTTGCTTCAG
GGTTGCTTCAG -> GTTGCTTCAGC
GTTGCTTCAGC -> TTGCTTCAGCG
TTGCTTCAGCG -> TGCTTCAGCGT
TGCTTCAGCGT -> GCTTCAGCGTA
GCTTCAGCGTA -> CTTCAGCGTAT
CTTCAGCGTAT -> TTCAGCGTATC
TTCAGCGTATC -> TCAGCGTATCG
TCAGCGTATCG -> CAGCGTATCGA
CAGCGTATCGA -> AGCGTATCGAA
AGCGTATCGAA -> GCGTATCGAAG
GCGTATCGAAG -> CGTATCGAAGC
CGTATCGAAGC -> GTATCGAAGCT
GTATCGAAGCT -> TATCGAAGCTC
TATCGAAGCTC -> ATCGAAGCTCC
ATCGAAGCTCC -> TCGAAGCTCCT
TCGAAGCTCCT -> CGAAGCTCCTG
CGAAGCTCCTG -> GAAGCTCCTGT
GAAGCTCCTGT -> AAGCTCCTGTG
AAGCTCCTGTG -> AGCTCCTGTGG
AGCTCCTGTGG -> GCTCCTGTGGA
GCTCCTGTGGA -> CTCCTGTGGAA
CTCCTGTGGAA -> TCCTGTGGAAT
TCCTGTGGAAT -> CCTGTGGAATC
CCTGTGGAATC -> CTGTGGAATCG
CTGTGGAATCG -> TGTGGAATCGC
TGTGGAATCGC -> GTGGAATCGCG
GTGGAATCGCG -> TGGAATCGCGA
TGGAATCGCGA -> GGAATCGCGAG
GGAATCGCGAG -> GAATCGCGAGC
GAATCGCGAGC -> AATCGCGAGCT
AATCGCGAGCT -> ATCGCGAGCTG
ATCGCGAGCTG -> TCGCGAGCTGC
TCGCGAGCTGC -> CGCGAGCTGCC
CGCGAGCTGCC -> GCGAGCTGCCT
GCGAGCTGCCT -> CGAGCTGCCTC
CGAGCTGCCTC -> GAGCTGCCTCC
GAGCTGCCTCC -> AGCTGCCTCCC
AGCTGCCTCCC -> GCTGCCTCCCA
GCTGCCTCCCA -> CTGCCTCCCAT
CTGCCTCCCAT -> TGCCTCCCATC
TGCCTCCCATC -> GCCTCCCATCG
GCCTCCCATCG -> CCTCCCATCGG
CCTCCCATCGG -> CTCCCATCGGC
CTCCCATCGGC -> TCCCATCGGCG
TCCCATCGGCG -> CCCATCGGCGC
CCCATCGGCGC -> CCATCGGCGCG
CCATCGGCGCG -> CATCGGCGCGC
CATCGGCGCGC -> ATCGGCGCGCA
ATCGGCGCGCA -> TCGGCGCGCAA
TCGGCGCGCAA -> CGGCGCGCAAA
CGGCGCGCAAA -> GGCGCGCAAAA
GGCGCGCAAAA -> GCGCGCAAAAA
GCGCGCAAAAA -> CGCGCAAAAAA
CGCGCAAAAAA -> GCGCAAAAAAC
GCGCAAAAAAC -> CGCAAAAAACT
CGCAAAAAACT -> GCAAAAAACTG
GCAAAAAACTG -> CAAAAAACTGT
CAAAAAACTGT -> AAAAAACTGTC
AAAAAACTGTC -> AAAAACTGTCC
AAAAACTGTCC -> AAAACTGTCCT
AAAACTGTCCT -> AAACTGTCCTC
AAACTGTCCTC -> AACTGTCCTCA
AACTGTCCTCA -> ACTGTCCTCAT
ACTGTCCTCAT -> CTGTCCTCATT
CTGTCCTCATT -> TGTCCTCATTT
TGTCCTCATTT -> GTCCTCATTTG
GTCCTCATTTG -> TCCTCATTTGA
TCCTCATTTGA -> CCTCATTTGAG
CCTCATTTGAG -> CTCATTTGAGA
CTCATTTGAGA -> TCATTTGAGAG
TCATTTGAGAG -> CATTTGAGAGC
CATTTGAGAGC -> ATTTGAGAGCA
ATTTGAGAGCA -> TTTGAGAGCAC
TTTGAGAGCAC -> TTGAGAGCACC
TTGAGAGCACC -> TGAGAGCACCC
TGAGAGCACCC -> GAGAGCACCCA
GAGAGCACCCA -> AGAGCACCCAG
AGAGCACCCAG -> GAGCACCCAGT
GAGCACCCAGT -> AGCACCCAGTT
AGCACCCAGTT -> GCACCCAGTTA
GCACCCAGTTA -> CACCCAGTTAC
CACCCAGTTAC -> ACCCAGTTACT
ACCCAGTTACT -> CCCAGTTACTA
CCCAGTTACTA -> CCAGTTACTAA
CCAGTTACTAA -> CAGTTACTAAC
CAGTTACTAAC -> AGTTACTAACG
AGTTACTAACG -> GTTACTAACGA
GTTACTAACGA -> TTACTAACGAC
TTACTAACGAC -> TACTAACGACG
TACTAACGACG -> ACTAACGACGT
ACTAACGACGT -> CTAACGACGTC
CTAACGACGTC -> TAACGACGTCT
TAACGACGTCT -> AACGACGTCTG
AACGACGTCTG -> ACGACGTCTGT
ACGACGTCTGT -> CGACGTCTGTT
CGACGTCTGTT -> GACGTCTGTTT
GACGTCTGTTT -> ACGTCTGTTTC
ACGTCTGTTTC -> CGTCTGTTTCG
CGTCTGTTTCG -> GTCTGTTTCGT
GTCTGTTTCGT -> TCTGTTTCGTA
TCTGTTTCGTA -> CTGTTTCGTAC
CTGTTTCGTAC -> TGTTTCGTACA
TGTTTCGTACA -> GTTTCGTACAT
GTTTCGTACAT -> TTTCGTACATT
TTTCGTACATT -> TTCGTACATTG
TTCGTACATTG -> TCGTACATTGA
TCGTACATTGA -> CGTACATTGAG
CGTACATTGAG -> GTACATTGAGA
GTACATTGAGA -> TACATTGAGAT
TACATTGAGAT -> ACATTGAGATC
ACATTGAGATC -> CATTGAGATCT
CATTGAGATCT -> ATTGAGATCTT
ATTGAGATCTT -> TTGAGATCTTA
TTGAGATCTTA -> TGAGATCTTAC
TGAGATCTTAC -> GAGATCTTACG
GAGATCTTACG -> AGATCTTACGT
AGATCTTACGT -> GATCTTACGTG
GATCTTACGTG -> ATCTTACGTGA
ATCTTACGTGA -> TCTTACGTGAA
TCTTACGTGAA -> CTTACGTGAAG
CTTACGTGAAG -> TTACGTGAAGT
TTACGTGAAGT -> TACGTGAAGTG
TACGTGAAGTG -> ACGTGAAGTGA
ACGTGAAGTGA -> CGTGAAGTGAG
CGTGAAGTGAG -> GTGAAGTGAGG
GTGAAGTGAGG -> TGAAGTGAGGC
TGAAGTGAGGC -> GAAGTGAGGCA
GAAGTGAGGCA -> AAGTGAGGCAG
AAGTGAGGCAG -> AGTGAGGCAGA
AGTGAGGCAGA -> GTGAGGCAGAG
GTGAGGCAGAG -> TGAGGCAGAGT
TGAGGCAGAGT -> GAGGCAGAGTT
GAGGCAGAGTT -> AGGCAGAGTTC
AGGCAGAGTTC -> GGCAGAGTTCG
GGCAGAGTTCG -> GCAGAGTTCGA
GCAGAGTTCGA -> CAGAGTTCGAA
CAGAGTTCGAA -> AGAGTTCGAAC
AGAGTTCGAAC -> GAGTTCGAACC
GAGTTCGAACC -> AGTTCGAACCA
AGTTCGAACCA -> GTTCGAACCAA
GTTCGAACCAA -> TTCGAACCAAG
TTCGAACCAAG -> TCGAACCAAGG
TCGAACCAAGG -> CGAACCAAGGG
CGAACCAAGGG -> GAACCAAGGGG
GAACCAAGGGG -> AACCAAGGGGC
AACCAAGGGGC -> ACCAAGGGGCC
ACCAAGGGGCC -> CCAAGGGGCCC
CCAAGGGGCCC -> CAAGGGGCCCT
CAAGGGGCCCT -> AAGGGGCCCTC
AAGGGGCCCTC -> AGGGGCCCTCG
AGGGGCCCTCG -> GGGGCCCTCGC
GGGGCCCTCGC -> GGGCCCTCGCC
GGGCCCTCGCC -> GGCCCTCGCCC
GGCCCTCGCCC -> GCCCTCGCCCG
GCCCTCGCCCG -> CCCTCGCCCGG
CCCTCGCCCGG -> CCTCGCCCGGG
CCTCGCCCGGG -> CTCGCCCGGGA
CTCGCCCGGGA -> TCGCCCGGGAA
TCGCCCGGGAA -> CGCCCGGGAAT
CGCCCGGGAAT -> GCCCGGGAATC
GCCCGGGAATC -> CCCGGGAATCA
CCCGGGAATCA -> CCGGGAATCAC
CCGGGAATCAC -> CGGGAATCACC
CGGGAATCACC -> GGGAATCACCT
GGGAATCACCT -> GGAATCACCTT
GGAATCACCTT -> GAATCACCTTA
GAATCACCTTA -> AATCACCTTAG
AATCACCTTAG -> ATCACCTTAGC
ATCACCTTAGC -> TCACCTTAGCA
TCACCTTAGCA -> CACCTTAGCAT
CACCTTAGCAT -> ACCTTAGCATT
ACCTTAGCATT -> CCTTAGCATTA
CCTTAGCATTA -> CTTAGCATTAG
CTTAGCATTAG -> TTAGCATTAGA
TTAGCATTAGA -> TAGCATTAGAG
TAGCATTAGAG -> AGCATTAGAGA
AGCATTAGAGA -> GCATTAGAGAC
GCATTAGAGAC -> CATTAGAGACA
CATTAGAGACA -> ATTAGAGACAA
ATTAGAGACAA -> TTAGAGACAAA
TTAGAGACAAA -> TAGAGACAAAT
TAGAGACAAAT -> AGAGACAAATT
AGAGACAAATT -> GAGACAAATTA
GAGACAAATTA -> AGACAAATTAC
AGACAAATTAC -> GACAAATTACT
GACAAATTACT -> ACAAATTACTT
ACAAATTACTT -> CAAATTACTTG
CAAATTACTTG -> AAATTACTTGG
AAATTACTTGG -> AATTACTTGGA
AATTACTTGGA -> ATTACTTGGAT
ATTACTTGGAT -> TTACTTGGATC
TTACTTGGATC -> TACTTGGATCG
TACTTGGATCG -> ACTTGGATCGG
ACTTGGATCGG -> CTTGGATCGGC
CTTGGATCGGC -> TTGGATCGGCC
TTGGATCGGCC -> TGGATCGGCCC
TGGATCGGCCC -> GGATCGGCCCT
GGATCGGCCCT -> GATCGGCCCTA
GATCGGCCCTA -> ATCGGCCCTAG
ATCGGCCCTAG -> TCGGCCCTAGG
TCGGCCCTAGG -> CGGCCCTAGGG
CGGCCCTAGGG -> GGCCCTAGGGT
GGCCCTAGGGT -> GCCCTAGGGTC
GCCCTAGGGTC -> CCCTAGGGTCT
CCCTAGGGTCT -> CCTAGGGTCTC
CCTAGGGTCTC -> CTAGGGTCTCC
CTAGGGTCTCC -> TAGGGTCTCCA
TAGGGTCTCCA -> AGGGTCTCCAA
AGGGTCTCCAA -> GGGTCTCCAAG
GGGTCTCCAAG -> GGTCTCCAAGT
GGTCTCCAAGT -> GTCTCCAAGTG
GTCTCCAAGTG -> TCTCCAAGTGA
TCTCCAAGTGA -> CTCCAAGTGAG
CTCCAAGTGAG -> TCCAAGTGAGT
TCCAAGTGAGT -> CCAAGTGAGTT
CCAAGTGAGTT -> CAAGTGAGTTA
CAAGTGAGTTA -> AAGTGAGTTAA
AAGTGAGTTAA -> AGTGAGTTAAT
AGTGAGTTAAT -> GTGAGTTAATG
GTGAGTTAATG -> TGAGTTAATGA
TGAGTTAATGA -> GAGTTAATGAT
GAGTTAATGAT -> AGTTAATGATC
AGTTAATGATC -> GTTAATGATCA
GTTAATGATCA -> TTAATGATCAA
TTAATGATCAA -> TAATGATCAAT
TAATGATCAAT -> AATGATCAATC
AATGATCAATC -> ATGATCAATCT
ATGATCAATCT -> TGATCAATCTC
TGATCAATCTC -> GATCAATCTCG
GATCAATCTCG -> ATCAATCTCGT
ATCAATCTCGT -> TCAATCTCGTC
TCAATCTCGTC -> CAATCTCGTCG
CAATCTCGTCG -> AATCTCGTCGC
AATCTCGTCGC -> ATCTCGTCGCC
ATCTCGTCGCC -> TCTCGTCGCCG
TCTCGTCGCCG -> CTCGTCGCCGG
CTCGTCGCCGG -> TCGTCGCCGGC
TCGTCGCCGGC -> CGTCGCCGGCC
CGTCGCCGGCC -> GTCGCCGGCCG
GTCGCCGGCCG -> TCGCCGGCCGC
TCGCCGGCCGC -> CGCCGGCCGCG
CGCCGGCCGCG -> GCCGGCCGCGG
GCCGGCCGCGG -> CCGGCCGCGGG
CCGGCCGCGGG -> CGGCCGCGGGT
CGGCCGCGGGT -> GGCCGCGGGTG
GGCCGCGGGTG -> GCCGCGGGTGG
GCCGCGGGTGG -> CCGCGGGTGGT
CCGCGGGTGGT -> CGCGGGTGGTT
CGCGGGTGGTT -> GCGGGTGGTTG
GCGGGTGGTTG -> CGGGTGGTTGG
CGGGTGGTTGG -> GGGTGGTTGGT
GGGTGGTTGGT -> GGTGGTTGGTC
GGTGGTTGGTC -> GTGGTTGGTCG
GTGGTTGGTCG -> TGGTTGGTCGT
TGGTTGGTCGT -> GGTTGGTCGTA
GGTTGGTCGTA -> GTTGGTCGTAG
GTTGGTCGTAG -> TTGGTCGTAGT
TTGGTCGTAGT -> TGGTCGTAGTT
TGGTCGTAGTT -> GGTCGTAGTTT
GGTCGTAGTTT -> GTCGTAGTTTT
GTCGTAGTTTT -> TCGTAGTTTTG
TCGTAGTTTTG -> CGTAGTTTTGA
CGTAGTTTTGA -> GTAGTTTTGAG
GTAGTTTTGAG -> TAGTTTTGAGC
TAGTTTTGAGC -> AGTTTTGAGCT
AGTTTTGAGCT -> GTTTTGAGCTC
GTTTTGAGCTC -> TTTTGAGCTCC
TTTTGAGCTCC -> TTTGAGCTCCA
TTTGAGCTCCA -> TTGAGCTCCAT
TTGAGCTCCAT -> TGAGCTCCATA
TGAGCTCCATA -> GAGCTCCATAA
GAGCTCCATAA -> AGCTCCATAAG
AGCTCCATAAG -> GCTCCATAAGG
GCTCCATAAGG -> CTCCATAAGGA
CTCCATAAGGA -> TCCATAAGGAG
TCCATAAGGAG -> CCATAAGGAGC
CCATAAGGAGC -> CATAAGGAGCG
CATAAGGAGCG -> ATAAGGAGCGC
ATAAGGAGCGC -> TAAGGAGCGCA
TAAGGAGCGCA -> AAGGAGCGCAT
AAGGAGCGCAT -> AGGAGCGCATT
AGGAGCGCATT -> GGAGCGCATTA
GGAGCGCATTA -> GAGCGCATTAC
GAGCGCATTAC -> AGCGCATTACT
AGCGCATTACT -> GCGCATTACTG
GCGCATTACTG -> CGCATTACTGG
CGCATTACTGG -> GCATTACTGGA
GCATTACTGGA -> CATTACTGGAA
CATTACTGGAA -> ATTACTGGAAA
ATTACTGGAAA -> TTACTGGAAAC
TTACTGGAAAC -> TACTGGAAACC
TACTGGAAACC -> ACTGGAAACCC
ACTGGAAACCC -> CTGGAAACCCC
